Title,Worldwide Earnings,Domestic Earnings,Domestic Percent Earnings,Foreign Earnings,Foreign Percent Earnings,Year
Mission: Impossible II,546388108,215409889,39.4,330978219,60.6,2000
Gladiator,460583960,187705427,40.8,272878533,59.2,2000
Cast Away,429632142,233632142,54.4,196000000,45.6,2000
What Women Want,374111707,182811707,48.9,191300000,51.1,2000
Dinosaur,349822765,137748063,39.4,212074702,60.6,2000
How the Grinch Stole Christmas,345842198,260745620,75.4,85096578,24.6,2000
Meet the Parents,330444045,166244045,50.3,164200000,49.7,2000
The Perfect Storm,328718434,182618434,55.6,146100000,44.4,2000
X0Men,296339528,157299718,53.1,139039810,46.9,2000
What Lies Beneath,291420351,155464351,53.3,135956000,46.7,2000
Scary Movie,278019771,157019771,56.5,121000000,43.5,2000
Charlie's Angels,264105545,125305545,47.4,138800000,52.6,2000
Erin Brockovich,256271286,125595205,49.0,130676081,51.0,2000
Unbreakable,248118121,95011339,38.3,153106782,61.7,2000
Gone in 60 Seconds,237202299,101648571,42.9,135553728,57.1,2000
Chicken Run,224834564,106834564,47.5,118000000,52.5,2000
Vertical Limit,215663859,69243859,32.1,146420000,67.9,2000
The Patriot,215294342,113330342,52.6,101964000,47.4,2000
Crouching Tiger Hidden Dragon,213525736,128078872,60.0,85446864,40.0,2000
Miss Congeniality,212742720,106807667,50.2,105935053,49.8,2000
Traffic,207515725,124115725,59.8,83400000,40.2,2000
Hollow Man,190213455,73209340,38.5,117004115,61.5,2000
102 Dalmatians,183611771,66957026,36.5,116654745,63.5,2000
Big Momma's House,173959438,117559438,67.6,56400000,32.4,2000
The Emperor's New Groove,169327687,89302687,52.7,80025000,47.3,2000
Nutty Professor II: The Klumps,166339890,123309890,74.1,43030000,25.9,2000
Scream 3,161834276,89143175,55.1,72691101,44.9,2000
Chocolat,152699946,71509363,46.8,81190583,53.2,2000
Me Myself & Irene,149270999,90570999,60.7,58700000,39.3,2000
The Beach,144056873,39785027,27.6,104271846,72.4,2000
Remember the Titans,136706683,115654751,84.6,21051932,15.4,2000
Pok√©mon the Movie 2000,133949270,43758684,32.7,90190586,67.3,2000
Space Cowboys,128884132,90464773,70.2,38419359,29.8,2000
U0571,127666415,77122415,60.4,50544000,39.6,2000
The Family Man,124745083,75793305,60.8,48951778,39.2,2000
Road Trip,119754278,68540777,57.2,51213501,42.8,2000
Coyote Ugly,113916474,60786269,53.4,53130205,46.6,2000
Final Destination,112880294,53331147,47.2,59549147,52.8,2000
The Exorcist 2000 Director's Cut,112053066,39671011,35.4,72382055,64.6,2000
Mission to Mars,110983407,60883407,54.9,50100000,45.1,2000
The Kid,110317580,69691949,63.2,40625631,36.8,2000
Billy Elliot,109280263,21995263,20.1,87285000,79.9,2000
Shaft,107196498,70334258,65.6,36862240,34.4,2000
The Whole Nine Yards,106371651,57262492,53.8,49109159,46.2,2000
The Cell,104155843,61334059,58.9,42821784,41.1,2000
Rugrats in Paris,103291131,76507756,74.1,26783375,25.9,2000
Shanghai Noon,99274467,56937502,57.4,42336965,42.6,2000
The Tigger Movie,96159800,45554533,47.4,50605267,52.6,2000
The 6th Day,96085477,34604280,36.0,61481197,64.0,2000
Romeo Must Die,91036760,55973336,61.5,35063424,38.5,2000
Fantasia 2000,90874570,60655420,66.7,30219150,33.3,2000
Autumn in New York,90726668,37761915,41.6,52964753,58.4,2000
Bring It On,90449929,68379000,75.6,22070929,24.4,2000
Bedazzled,90383208,37886980,41.9,52496228,58.1,2000
Snatch,83557872,30328156,36.3,53229716,63.7,2000
Men of Honor,82343495,48818921,59.3,33524574,40.7,2000
Finding Forrester,80049764,51804714,64.7,28245050,35.3,2000
The Road to El Dorado,76432727,50863742,66.5,25568985,33.5,2000
Dude Where's My Car?,73180723,46729800,63.9,26450923,36.1,2000
O Brother Where Art Thou?,71868327,45512588,63.3,26355739,36.7,2000
Rules of Engagement,71732303,61335230,85.5,10397073,14.5,2000
Frequency,68106245,45010278,66.1,23095967,33.9,2000
Thirteen Days,66579890,34592089,52.0,31987801,48.0,2000
Proof of Life,62761005,32598931,51.9,30162074,48.1,2000
Snow Day,62464731,60020107,96.1,2444624,3.9,2000
28 Days,62198945,37170488,59.8,25028457,40.2,2000
Taxi 2,60726164,626164,1.0,60100000,99.0,2000
Keeping the Faith,59945183,37047880,61.8,22897303,38.2,2000
Next Friday,59827328,57328603,95.8,2498725,4.2,2000
The Flintstones in Viva Rock Vegas,59468275,35268275,59.3,24200000,40.7,2000
Little Nicky,58292295,39464775,67.7,18827520,32.3,2000
Pay It Forward,55707411,33519628,60.2,22187783,39.8,2000
Bounce,53425292,36805288,68.9,16620004,31.1,2000
Pitch Black,53187659,39240659,73.8,13947000,26.2,2000
Hanging Up,51880044,36050230,69.5,15829814,30.5,2000
The Skulls,50802120,35046120,69.0,15756000,31.0,2000
The Replacements,50054511,44737059,89.4,5317452,10.6,2000
Book of Shadows: Blair Witch 2,47737094,26437094,55.4,21300000,44.6,2000
Almost Famous,47383689,32534850,68.7,14848839,31.3,2000
The Watcher,47267829,28946615,61.2,18321214,38.8,2000
High Fidelity,47126295,27287137,57.9,19839158,42.1,2000
Dracula 2000,47053625,33022767,70.2,14030858,29.8,2000
The Gift,44567606,12008642,26.9,32558964,73.1,2000
Where the Heart Is,40863718,33772838,82.6,7090880,17.4,2000
Bless the Child,40443010,29381494,72.6,11061516,27.4,2000
The Art of War,40400425,30208599,74.8,10191826,25.2,2000
Dancer in the Dark,40031879,4184036,10.5,35847843,89.5,2000
The Legend of Bagger Vance,39459427,30919168,78.4,8540259,21.6,2000
Urban Legends: Final Cut,38574362,21468807,55.7,17105555,44.3,2000
The Original Kings of Comedy,38182790,38182790,100.0,0,0.0,2000
Titan A.E.,36754634,22753426,61.9,14001208,38.1,2000
Return to Me,36609995,32722798,89.4,3887197,10.6,2000
My Dog Skip,35547761,34134641,96.0,1413120,4.0,2000
The Adventures of Rocky & Bullwinkle,35134820,26005820,74.0,9129000,26.0,2000
American Psycho,34266564,15070285,44.0,19196279,56.0,2000
Dungeons & Dragons,33978694,15391970,45.3,18586724,54.7,2000
Red Planet,33463969,17480890,52.2,15983079,47.8,2000
Wonder Boys,33426588,19393557,58.0,14033031,42.0,2000
Reindeer Games,32168970,23368995,72.6,8799975,27.4,2000
Lost Souls,31355910,16815253,53.6,14540657,46.4,2000
Small Time Crooks,29934477,17266359,57.7,12668118,42.3,2000
Battlefield Earth,29725663,21471685,72.2,8253978,27.8,2000
Nurse Betty,29360400,25170054,85.7,4190346,14.3,2000
Boiler Room,28780255,16970581,59.0,11809674,41.0,2000
The Little Vampire,27965865,13572400,48.5,14393465,51.5,2000
Love & Basketball,27728118,27459615,99.0,268503,1.0,2000
Cirque du Soleil: Journey of Man,27538359,15627434,56.7,11910925,43.3,2000
Center Stage,26385941,17200925,65.2,9185016,34.8,2000
Saving Grace,26330482,12178602,46.3,14151880,53.7,2000
Boys and Girls,25850615,21799652,84.3,4050963,15.7,2000
Down to You,24419914,20069008,82.2,4350906,17.8,2000
The Next Best Thing,24362772,14990582,61.5,9372190,38.5,2000
Dr. T & the Women,22844291,13113041,57.4,9731250,42.6,2000
The Contender,22361811,17872723,79.9,4489088,20.1,2000
Michael Jordan to the Max,21268532,18650521,87.7,2618011,12.3,2000
Best in Show,20789556,18715392,90.0,2074164,10.0,2000
Thomas and the Magic Railroad,19748009,15933506,80.7,3814503,19.3,2000
Get Carter,19412993,14967182,77.1,4445811,22.9,2000
The Ninth Gate,18661336,18661336,100.0,0,0.0,2000
Loser,18404706,15618626,84.9,2786080,15.1,2000
All the Pretty Horses,18133495,15540353,85.7,2593142,14.3,2000
Quills,17989227,7065332,39.3,10923895,60.7,2000
CyberWorld,16653900,11253900,67.6,5400000,32.4,2000
Digimon: The Movie,16643191,9631153,57.9,7012038,42.1,2000
The Dish,16575074,2552992,15.4,14022082,84.6,2000
Italian for Beginners,16349568,4544753,27.8,11804815,72.2,2000
Drowning Mona,15906764,15506764,97.5,400000,2.5,2000
Highlander: Endgame,15843608,12811858,80.9,3031750,19.1,2000
Bait,15471969,15325127,99.1,146842,0.9,2000
Supernova,14828081,14230455,96.0,597626,4.0,2000
Malena,14493284,3448233,23.8,11045051,76.2,2000
I Dreamed of Africa,14400327,6651522,46.2,7748805,53.8,2000
What Planet Are You From?,14145677,6291602,44.5,7854075,55.5,2000
The Ladies Man,13743212,13616610,99.1,126602,0.9,2000
Solarmax,13400161,13400161,100.0,0,0.0,2000
The Crew,13105853,13023075,99.4,82778,0.6,2000
The Way of the Gun,13069740,6055661,46.3,7014079,53.7,2000
In the Mood for Love,12854953,2738980,21.3,10115973,78.7,2000
Gossip,12591270,5108820,40.6,7482450,59.4,2000
Ready to Rumble,12452362,12394327,99.5,58035,0.5,2000
Drunken Master II,11555430,11555430,100.0,0,0.0,2000
You Can Count on Me,11242521,9416804,83.8,1825717,16.2,2000
Shadow of the Vampire,11155214,8293784,74.3,2861430,25.7,2000
Lucky Numbers,10890222,10042516,92.2,847706,7.8,2000
Here on Earth,10873148,10522168,96.8,350980,3.2,2000
Pollock,10558970,8598593,81.4,1960377,18.6,2000
Anatomy,10501958,9660,0.1,10492298,99.9,2000
The Virgin Suicides,10409377,4906229,47.1,5503148,52.9,2000
Woman on Top,10194274,5020111,49.2,5174163,50.8,2000
Godzilla 2000,10037390,10037390,100.0,0,0.0,2000
Whatever It Takes,9902115,8745680,88.3,1156435,11.7,2000
3 Strikes,9832166,9832166,100.0,0,0.0,2000
Bread and Tulips,9719848,5318679,54.7,4401169,45.3,2000
Ghost Dog: The Way of the Samurai,9380473,3308029,35.3,6072444,64.7,2000
State and Main,9206279,6944471,75.4,2261808,24.6,2000
Before Night Falls,8527517,4242892,49.8,4284625,50.2,2000
Butterfly,7733894,2092682,27.1,5641212,72.9,2000
Ants in the Pants,7625967,0,0.0,7625967,100.0,2000
Requiem for a Dream,7390108,3635482,49.2,3754626,50.8,2000
Where the Money Is,7243669,5661798,78.2,1581871,21.8,2000
Screwed,7201701,7027345,97.6,174356,2.4,2000
Widow of St. Pierre,7193889,3193889,44.4,4000000,55.6,2000
Croupier,7075068,6201143,87.6,873925,12.4,2000
Duets,6620242,4739023,71.6,1881219,28.4,2000
Now or Never,5995963,0,0.0,5995963,100.0,2000
Black & White,5541431,5277299,95.2,264132,4.8,2000
The in Crowd,5280035,5280035,100.0,0,0.0,2000
The House of Mirth,5164404,3043284,58.9,2121120,41.1,2000
Otto 0 Der Katastrofenfilm,5058355,0,0.0,5058355,100.0,2000
Whipped,4775009,4159986,87.1,615023,12.9,2000
Held Up,4705631,4705631,100.0,0,0.0,2000
The Jungle Book 2000 Re0release,4466472,0,0.0,4466472,100.0,2000
The Tao of Steve,4406030,4342203,98.6,63827,1.4,2000
Mohabbatein,4279351,1070000,25.0,3209351,75.0,2000
East Is East,4177818,4177818,100.0,0,0.0,2000
Bossa Nova,4069261,1823297,44.8,2245964,55.2,2000
Erkan & Stefan,4026949,0,0.0,4026949,100.0,2000
Pettson & Findus 0 Katten och gubbens √•r,3920489,0,0.0,3920489,100.0,2000
Up at the Villa,3740113,2933161,78.4,806952,21.6,2000
The Big Kahuna,3728888,3165544,84.9,563344,15.1,2000
Price of Glory,3548556,3440228,96.9,108328,3.1,2000
Gun Shy,3221280,1638202,50.9,1583078,49.1,2000
Beautiful,3169930,3157348,99.6,12582,0.4,2000
Isn't She Great,3003296,2962465,98.6,40831,1.4,2000
No More School,2870533,0,0.0,2870533,100.0,2000
Flickering Lights,2760019,0,0.0,2760019,100.0,2000
The Color of Paradise,2724595,1817216,66.7,907379,33.3,2000
God's Army,2637726,2637726,100.0,0,0.0,2000
But I'm a Cheerleader,2595216,2205627,85.0,389589,15.0,2000
Bamboozled,2463650,2274979,92.3,188671,7.7,2000
East/West,2321029,2321029,100.0,0,0.0,2000
Shower,2150929,1157764,53.8,993165,46.2,2000
Left Luggage,2111280,1069540,50.7,1041740,49.3,2000
Blood Simple 2000 Re0release,2068701,1701855,82.3,366846,17.7,2000
Marlene,2061924,0,0.0,2061924,100.0,2000
Hamlet,2046433,1577287,77.1,469146,22.9,2000
The Broken Hearts Club: A Romantic Comedy,2019121,1746585,86.5,272536,13.5,2000
Cecil B. Demented,1961544,1284646,65.5,676898,34.5,2000
The Life and Times of Hank Greenberg,1712385,1712385,100.0,0,0.0,2000
The Girl on the Bridge,1708839,1708839,100.0,0,0.0,2000
Harry Potter and the Sorcerer's Stone,974755371,317575550,32.6,657179821,67.4,2001
The Lord of the Rings: The Fellowship of the Ring,868385360,313364114,36.1,555021246,63.9,2001
Monsters Inc.,528773250,255873250,48.4,272900000,51.6,2001
Shrek,484596038,267851831,55.3,216744207,44.7,2001
Ocean's Eleven,450717150,183417150,40.7,267300000,59.3,2001
Pearl Harbor,449220945,198542554,44.2,250678391,55.8,2001
The Mummy Returns,433013274,202019785,46.7,230993489,53.3,2001
Jurassic Park III,368780809,181171875,49.1,187608934,50.9,2001
Planet of the Apes,362211740,180011740,49.7,182200000,50.3,2001
Hannibal,351692268,165092268,46.9,186600000,53.1,2001
Rush Hour 2,347325802,226164286,65.1,121161516,34.9,2001
A Beautiful Mind,313542341,170742341,54.5,142800000,45.5,2001
American Pie 2,287553595,145103595,50.5,142450000,49.5,2001
Bridget Jones's Diary,281929795,71543427,25.4,210386368,74.6,2001
Spirited Away,274925095,10055859,3.7,264869236,96.3,2001
Lara Croft: Tomb Raider,274703340,131168070,47.7,143535270,52.3,2001
A.I. Artificial Intelligence,235926552,78616689,33.3,157309863,66.7,2001
The Others,209947037,96522687,46.0,113424350,54.0,2001
The Fast and the Furious,207283925,144533925,69.7,62750000,30.3,2001
Vanilla Sky,203388341,100618344,49.5,102769997,50.5,2001
Cats & Dogs,200687492,93385515,46.5,107301977,53.5,2001
Atlantis: The Lost Empire,186053725,84056472,45.2,101997253,54.8,2001
Moulin Rouge!,179213434,57386607,32.0,121826827,68.0,2001
Dr. Dolittle 2,176104344,112952899,64.1,63151445,35.9,2001
Am√©lie,173921954,33225499,19.1,140696455,80.9,2001
Black Hawk Down,172989651,108638745,62.8,64350906,37.2,2001
The Princess Diaries,165335153,108248956,65.5,57086197,34.5,2001
Spy Kids,147934180,112719001,76.2,35215179,23.8,2001
The Mexican,147845033,66845033,45.2,81000000,54.8,2001
Swordfish,147080413,69772969,47.4,77307444,52.6,2001
Spy Game,143049560,62362560,43.6,80687000,56.4,2001
Legally Blonde,141774679,96520674,68.1,45254005,31.9,2001
Scary Movie 2,141220678,71308997,50.5,69911681,49.5,2001
Shallow Hal,141069860,70839203,50.2,70230657,49.8,2001
America's Sweethearts,138307673,93607673,67.7,44700000,32.3,2001
Save the Last Dance,131706809,91057006,69.1,40649803,30.9,2001
A Knight's Tale,117487473,56569702,48.1,60917771,51.9,2001
The Score,113579918,71107711,62.6,42472207,37.4,2001
Along Came a Spider,105178561,74078174,70.4,31100387,29.6,2001
Training Day,104876233,76631907,73.1,28244326,26.9,2001
Jimmy Neutron: Boy Genius,102992536,80936232,78.6,22056304,21.4,2001
Don't Say a Word,100020092,55001642,55.0,45018450,45.0,2001
Evolution,98376292,38345494,39.0,60030798,61.0,2001
I Am Sam,97818139,40311852,41.2,57506287,58.8,2001
Enemy at the Gates,96976270,51401758,53.0,45574512,47.0,2001
The Wedding Planner,94728529,60400856,63.8,34327673,36.2,2001
Behind Enemy Lines,91753202,58856790,64.1,32896412,35.9,2001
Gosford Park,87754044,41308615,47.1,46445429,52.9,2001
Ali,87713825,58203105,66.4,29510720,33.6,2001
Rat Race,85498534,56618055,66.2,28880479,33.8,2001
Final Fantasy: The Spirits Within,85131830,32131830,37.7,53000000,62.3,2001
The Animal,84772742,57743062,68.1,27029680,31.9,2001
Blow,83282296,52990775,63.6,30291521,36.4,2001
Exit Wounds,79958599,51758599,64.7,28200000,35.3,2001
Serendipity,77516304,50294317,64.9,27221987,35.1,2001
Kate & Leopold,76019048,47121859,62.0,28897189,38.0,2001
Manitou's Shoe,75482094,0,0.0,75482094,100.0,2001
From Hell,74558115,31602566,42.4,42955549,57.6,2001
The One,72689126,43905746,60.4,28783380,39.6,2001
The Royal Tenenbaums,71441250,52364010,73.3,19077240,26.7,2001
Down to Earth,71186502,64186502,90.2,7000000,9.8,2001
Brotherhood of the Wolf,70752904,11260096,15.9,59492808,84.1,2001
Thir13en Ghosts,68467960,41867960,61.1,26600000,38.9,2001
Pok√©mon 3 the Movie: Spell of the Unown,68411275,17052128,24.9,51359147,75.1,2001
Bandits,67631903,41575141,61.5,26056762,38.5,2001
Not Another Teen Movie,66468332,38252284,57.5,28216048,42.5,2001
Sweet November,65754228,25288103,38.5,40466125,61.5,2001
K0PAX,65001485,50338485,77.4,14663000,22.6,2001
Kiss of the Dragon,64437847,36845124,57.2,27592723,42.8,2001
Captain Corelli's Mandolin,62112895,25543895,41.1,36569000,58.9,2001
Zoolander,60780981,45172250,74.3,15608731,25.7,2001
The Crimson Rivers,60094966,594966,1.0,59500000,99.0,2001
Jeepers Creepers,59217789,37904175,64.0,21313614,36.0,2001
Heartbreakers,57756408,40336607,69.8,17419801,30.2,2001
15 Minutes,56359980,24403552,43.3,31956428,56.7,2001
Driven,54744738,32720065,59.8,22024673,40.2,2001
Domestic Disturbance,54249294,45246095,83.4,9003199,16.6,2001
The Closet,50104745,6678894,13.3,43425851,86.7,2001
Monster's Ball,44909486,31273922,69.6,13635564,30.4,2001
Recess: School's Out,44460850,36706141,82.6,7754709,17.4,2001
Hardball,44102389,40222729,91.2,3879660,8.8,2001
In the Bedroom,43368779,35930604,82.8,7438175,17.2,2001
See Spot Run,43057552,33357476,77.5,9700076,22.5,2001
Shaolin Soccer,42776760,489600,1.1,42287160,98.9,2001
Black Knight,39976235,33426971,83.6,6549264,16.4,2001
Memento,39723096,25544867,64.3,14178229,35.7,2001
Crocodile Dundee in Los Angeles,39438674,25635682,65.0,13802992,35.0,2001
Haunted Castle,39093166,13651656,34.9,25441510,65.1,2001
Someone Like You,38689940,27343067,70.7,11346873,29.3,2001
What's the Worst That Could Happen?,38464131,32269834,83.9,6194297,16.1,2001
The Majestic,37317558,27807266,74.5,9510292,25.5,2001
Valentine,36684136,20384136,55.6,16300000,44.4,2001
Joy Ride,36642838,21974919,60.0,14667919,40.0,2001
Riding in Cars with Boys,35743308,30165536,84.4,5577772,15.6,2001
Original Sin,35402320,16534221,46.7,18868099,53.3,2001
Jay and Silent Bob Strike Back,33788161,30085147,89.0,3703014,11.0,2001
And Your Mother Too,33616692,13839658,41.2,19777034,58.8,2001
The Musketeer,32533802,27073640,83.2,5460162,16.8,2001
Double Take,31603059,29831583,94.4,1771476,5.6,2001
How High,31283740,31178740,99.7,105000,0.3,2001
Beauty and the Beast 2000 IMAX Release,31033346,25487190,82.1,5546156,17.9,2001
Joe Dirt,30987695,27087695,87.4,3900000,12.6,2001
Hearts in Atlantis,30919415,24185781,78.2,6733634,21.8,2001
Monsoon Wedding,30787356,13885966,45.1,16901390,54.9,2001
Angel Eyes,29715606,24174218,81.4,5541388,18.6,2001
The Pledge,29419291,19733089,67.1,9686202,32.9,2001
Baby Boy,29381649,28734552,97.8,647097,2.2,2001
Heist,28510652,23510841,82.5,4999811,17.5,2001
The Tailor of Panama,28008462,13729742,49.0,14278720,51.0,2001
The Brothers,27958191,27457409,98.2,500782,1.8,2001
The Last Castle,27642707,18244060,66.0,9398647,34.0,2001
Saving Silverman,26086706,19402030,74.4,6684676,25.6,2001
Corky Romano,25272752,23980304,94.9,1292448,5.1,2001
The Shipping News,24690441,11434216,46.3,13256225,53.7,2001
Joe Somebody,24516772,22771646,92.9,1745126,7.1,2001
Nowhere in Africa,24322180,6180200,25.4,18141980,74.6,2001
Tanguy,24272365,0,0.0,24272365,100.0,2001
Life as a House,23903791,15667270,65.5,8236521,34.5,2001
The Glass House,23619609,18150259,76.8,5469350,23.2,2001
Tomcats,23430766,13558739,57.9,9872027,42.1,2001
Kingdom Come,23396049,23249649,99.4,146400,0.6,2001
Two Can Play That Game,22391450,22235901,99.3,155549,0.7,2001
Winged Migration,21493351,924651,4.3,20568700,95.7,2001
Amores Perros,20908467,5408467,25.9,15500000,74.1,2001
Mulholland Drive,20117339,7220243,35.9,12897096,64.1,2001
Himalaya 2001 Re0release,19960881,2487878,12.5,17473003,87.5,2001
Crazy/Beautiful,19937988,16937988,85.0,3000000,15.0,2001
Get Over It,19900366,11576464,58.2,8323902,41.8,2001
Summer Catch,19772447,19753553,99.9,18894,0.1,2001
Shackleton's Antarctic Adventure,19613216,15553324,79.3,4059892,20.7,2001
Rock Star,19334145,17008282,88.0,2325863,12.0,2001
O,19260537,16025437,83.2,3235100,16.8,2001
The Man Who Wasn't There,18916623,7504257,39.7,11412366,60.3,2001
The Curse of the Jade Scorpion,18914307,7517191,39.7,11397116,60.3,2001
3000 Miles to Graceland,18720175,15749959,84.1,2970216,15.9,2001
Max Keeble's Big Move,18634654,17294293,92.8,1340361,7.2,2001
Godzilla Mothra and King Ghidorah: Giant Monsters All0Out Attack,18623382,0,0.0,18623382,100.0,2001
Antitrust,18195610,11328094,62.3,6867516,37.7,2001
Jason X,16951798,13121555,77.4,3830243,22.6,2001
Sugar & Spice,16908947,13305101,78.7,3603846,21.3,2001
Just Visiting,16176732,4781539,29.6,11395193,70.4,2001
Iris,16153953,5594617,34.6,10559336,65.4,2001
Lantana,15747450,4623189,29.4,11124261,70.6,2001
Enigma 2001 Re0release,15705007,4301582,27.4,11403425,72.6,2001
With a Friend Like Harry...,15472186,3830441,24.8,11641745,75.2,2001
Brother,15250594,450594,3.0,14800000,97.0,2001
Josie and the Pussycats,14866015,14271015,96.0,595000,4.0,2001
Out Cold,14782676,13906394,94.1,876282,5.9,2001
Iron Monkey,14694904,14694904,100.0,0,0.0,2001
Together,14572229,1034829,7.1,13537400,92.9,2001
Freddy Got Fingered,14333252,14254993,99.5,78259,0.5,2001
Osmosis Jones,14026418,13596911,96.9,429507,3.1,2001
Ghosts of Mars,14010832,8709640,62.2,5301192,37.8,2001
American Outlaws,13678913,13342790,97.5,336123,2.5,2001
One Night at McCool's,13473370,6290673,46.7,7182697,53.3,2001
Vidocq,13240767,0,0.0,13240767,100.0,2001
Head Over Heels,13127022,10424470,79.4,2702552,20.6,2001
Formula 51,12881605,5204007,40.4,7677598,59.6,2001
The Girl from Paris,12812396,183266,1.4,12629130,98.6,2001
Apocalypse Now Redux,12543269,4626290,36.9,7916979,63.1,2001
Say It Isn't So,12320393,5520393,44.8,6800000,55.2,2001
The Son's Room,11767402,1016340,8.6,10751062,91.4,2001
Les rois mages,11702020,0,0.0,11702020,100.0,2001
The Experiment,11455141,0,0.0,11455141,100.0,2001
Kabhi Khushi Kabhie Gham...,11329690,2902000,25.6,8427690,74.4,2001
The Little Polar Bear,11243547,0,0.0,11243547,100.0,2001
Inuyasha the Movie: Affections Touching Across Time,10539779,0,0.0,10539779,100.0,2001
Town & Country,10372291,6719973,64.8,3652318,35.2,2001
Wasabi,10366360,97220,0.9,10269140,99.1,2001
The Wash,10229331,10097538,98.7,131793,1.3,2001
Sexy Beast,10045677,6946056,69.1,3099621,30.9,2001
Girls on Top,10038662,0,0.0,10038662,100.0,2001
The Deep End,10031529,8823109,88.0,1208420,12.0,2001
Mad Love,9306362,280046,3.0,9026316,97.0,2001
Kandahar,8914751,1418314,15.9,7496437,84.1,2001
Son of the Bride,8772695,624757,7.1,8147938,92.9,2001
Ghost World,8764007,6217849,70.9,2546158,29.1,2001
The Forsaken,8704851,7288451,83.7,1416400,16.3,2001
Tini: The New Life of Violetta,8678476,0,0.0,8678476,100.0,2001
The Prince and the Pirate,8579972,0,0.0,8579972,100.0,2001
Bones,8378853,7316658,87.3,1062195,12.7,2001
Merry Christmas,8228560,0,0.0,8228560,100.0,2001
The Hole,7644361,0,0.0,7644361,100.0,2001
Sex and Luc√≠a,7640680,1594779,20.9,6045901,79.1,2001
Monkeybone,7622365,5411999,71.0,2210366,29.0,2001
Mean Machine,7310206,92770,1.3,7217436,98.7,2001
The Slurb,6854681,0,0.0,6854681,100.0,2001
China: The Panda Adventure,6784985,3921642,57.8,2863343,42.2,2001
The Road Home,6780490,1280490,18.9,5500000,81.1,2001
The Piano Teacher,6749315,1012069,15.0,5737246,85.0,2001
Under the Sand,6531687,1452698,22.2,5078989,77.8,2001
The Devil's Backbone,6459020,755249,11.7,5703771,88.3,2001
Megiddo: The Omega Code 2,6047691,6047691,100.0,0,0.0,2001
Chaos,6042938,0,0.0,6042938,100.0,2001
Tom Thumb,5867304,0,0.0,5867304,100.0,2001
The Golden Bowl,5753678,3050532,53.0,2703146,47.0,2001
A Fish Tale,5595327,563911,10.1,5031416,89.9,2001
Made,5480653,5313300,96.9,167353,3.1,2001
Read My Lips,5393526,1471911,27.3,3921615,72.7,2001
Charlotte Gray,5323109,741394,13.9,4581715,86.1,2001
The Lord of the Rings: The Two Towers,923015234,339789881,36.8,583225353,63.2,2002
Harry Potter and the Chamber of Secrets,878979634,261988482,29.8,616991152,70.2,2002
Spider0Man,821708551,403706375,49.1,418002176,50.9,2002
Star Wars: Episode II 0 Attack of the Clones,645256452,302191252,46.8,343065200,53.2,2002
Men in Black II,441818803,190418803,43.1,251400000,56.9,2002
Die Another Day,431971116,160942139,37.3,271028977,62.7,2002
Signs,408247917,227966634,55.8,180281283,44.2,2002
Ice Age,383257136,176387405,46.0,206869731,54.0,2002
My Big Fat Greek Wedding,368744044,241438208,65.5,127305836,34.5,2002
Minority Report,358372926,132072926,36.9,226300000,63.1,2002
Catch Me If You Can,352114312,164615351,46.8,187498961,53.2,2002
Chicago,306776732,170687518,55.6,136089214,44.4,2002
Austin Powers in Goldmember,296938801,213307889,71.8,83630912,28.2,2002
xXx,277448382,142109382,51.2,135339000,48.8,2002
Scooby0Doo,275650703,153294164,55.6,122356539,44.4,2002
Lilo & Stitch,273144151,145794338,53.4,127349813,46.6,2002
The Ring,249348933,129128133,51.8,120220800,48.2,2002
8 Mile,242875078,116750901,48.1,126124177,51.9,2002
The Bourne Identity,214034224,121661683,56.8,92372541,43.2,2002
Red Dragon,209196298,93149898,44.5,116046400,55.5,2002
Two Weeks Notice,199043242,93354851,46.9,105688391,53.1,2002
Panic Room,196397415,96397334,49.1,100000081,50.9,2002
The Sum of All Fears,193921372,118907036,61.3,75014336,38.7,2002
Gangs of New York,193772504,77812000,40.2,115960504,59.8,2002
Road to Perdition,181001478,104454762,57.7,76546716,42.3,2002
Sweet Home Alabama,180622424,127223418,70.4,53399006,29.6,2002
The Scorpion King,178799308,91047077,50.9,87752231,49.1,2002
Hero,177395557,53710019,30.3,123685538,69.7,2002
The Santa Clause 2,172855065,139236327,80.6,33618738,19.4,2002
Mr. Deeds,171269535,126293452,73.7,44976083,26.3,2002
Stuart Little 2,169956806,64956806,38.2,105000000,61.8,2002
Blade II,155010032,82348319,53.1,72661713,46.9,2002
Maid in Manhattan,154906693,94011225,60.7,60895468,39.3,2002
About a Boy,130549455,41385278,31.7,89164177,68.3,2002
Space Station 3D,128363881,93383953,72.7,34979928,27.3,2002
The Time Machine,123729176,56832494,45.9,66896682,54.1,2002
Spirit: Stallion of the Cimarron,122563539,73280117,59.8,49283422,40.2,2002
The Pianist,120072577,32572577,27.1,87500000,72.9,2002
Spy Kids 2: Island of Lost Dreams,119723358,85846429,71.7,33876929,28.3,2002
Unfaithful,119137784,52775765,44.3,66362019,55.7,2002
Snow Dogs,115035090,81172560,70.6,33862530,29.4,2002
We Were Soldiers,114660784,78122718,68.1,36538066,31.9,2002
Insomnia,113714830,67355513,59.2,46359317,40.8,2002
Return to Never Land,109862682,48430258,44.1,61432424,55.9,2002
Treasure Planet,109578115,38176783,34.8,71401332,65.2,2002
The Hours,108846072,41675994,38.3,67170078,61.7,2002
Asterix & Obelix: Mission Cleopatra,108012365,0,0.0,108012365,100.0,2002
About Schmidt,105834556,65016287,61.4,40818269,38.6,2002
The Tuxedo,104391623,50547998,48.4,53843625,51.6,2002
Resident Evil,102984862,40119709,39.0,62865153,61.0,2002
John Q,102244770,71756802,70.2,30487968,29.8,2002
40 Days and 40 Nights,95146283,37950822,39.9,57195461,60.1,2002
Changing Lanes,94935764,66818548,70.4,28117216,29.6,2002
28 Days Later,82719885,45064915,54.5,37654970,45.5,2002
Reign of Fire,82150183,43061982,52.4,39088201,47.6,2002
The Rookie,80693537,75600072,93.7,5093465,6.3,2002
Jackass: The Movie,79493831,64255312,80.8,15238519,19.2,2002
Collateral Damage,78382433,40077257,51.1,38305176,48.9,2002
Showtime,77741732,38082712,49.0,39659020,51.0,2002
Windtalkers,77628265,40914068,52.7,36714197,47.3,2002
Barbershop,77063924,75782105,98.3,1281819,1.7,2002
Bend It Like Beckham,76583333,32543449,42.5,44039884,57.5,2002
The Count of Monte Cristo,75395048,54234062,71.9,21160986,28.1,2002
Divine Secrets of the Ya0Ya Sisterhood,73839240,69599016,94.3,4240224,5.7,2002
E.T. the Extra0Terrestrial 20th Anniversary,69177751,35306015,51.0,33871736,49.0,2002
The Sweetest Thing,68696770,24718164,36.0,43978606,64.0,2002
Ghost Ship,68349884,30113491,44.1,38236393,55.9,2002
Star Trek: Nemesis,67336470,43254409,64.2,24082061,35.8,2002
Bad Company,65977295,30160161,45.7,35817134,54.3,2002
K019: The Widowmaker,65716126,35168966,53.5,30547160,46.5,2002
High Crimes,63781810,41543917,65.1,22237893,34.9,2002
Like Mike,62274780,51432760,82.6,10842020,17.4,2002
Crossroads,61141030,37191304,60.8,23949726,39.2,2002
The Wild Thornberrys,60694737,40108697,66.1,20586040,33.9,2002
Bowling for Columbine,58008423,21576018,37.2,36432405,62.8,2002
Drumline,57588485,56399184,97.9,1189301,2.1,2002
Murder by Numbers,56714147,31945749,56.3,24768398,43.7,2002
Frida,56298474,25885000,46.0,30413474,54.0,2002
The Mothman Prophecies,55157539,35746370,64.8,19411169,35.2,2002
Analyze That,55003135,32130627,58.4,22872508,41.6,2002
The Hot Chick,54639553,35081594,64.2,19557959,35.8,2002
The Cat Returns,53452680,0,0.0,53452652,100.0,2002
Big Fat Liar,52970014,48360547,91.3,4609467,8.7,2002
Dragonfly,52323400,30323400,58.0,22000000,42.0,2002
One Hour Photo,52223306,31597131,60.5,20626175,39.5,2002
Blue Crush,51843679,40390647,77.9,11453032,22.1,2002
Enough,51806184,40007742,77.2,11798442,22.8,2002
I Spy,51386477,33561137,65.3,17825340,34.7,2002
Talk to Her 2002 Re0release,51001550,9285469,18.2,41716081,81.8,2002
A Walk to Remember,47494916,41281092,86.9,6213824,13.1,2002
Eight Legged Freaks,45867333,17322606,37.8,28544727,62.2,2002
Queen of the Damned,45479110,30336800,66.7,15142310,33.3,2002
The Transporter,43928932,25296447,57.6,18632485,42.4,2002
The Master of Disguise,43411001,40388794,93.0,3022207,7.0,2002
Orange County,43325009,41076018,94.8,2248991,5.2,2002
8 Women,42426583,3098776,7.3,39327807,92.7,2002
Undercover Brother,41604473,39089928,94.0,2514545,6.0,2002
Pinocchio,41314585,3675719,8.9,37638866,91.1,2002
Clockstoppers,38793283,36989956,95.4,1803327,4.6,2002
Van Wilder,38275483,21305259,55.7,16970224,44.3,2002
The Banger Sisters,38068353,30307416,79.6,7760937,20.4,2002
Halloween: Resurrection,37664855,30354442,80.6,7310413,19.4,2002
Swimfan,34411240,28564995,83.0,5846245,17.0,2002
Darkness,33988736,22163442,65.2,11825294,34.8,2002
Friday After Next,33526835,33253609,99.2,273226,0.8,2002
The Crocodile Hunter: Collision Course,33082548,28442574,86.0,4639974,14.0,2002
Confessions of a Dangerous Mind,33013805,16007718,48.5,17006087,51.5,2002
Adaptation.,32801173,22498520,68.6,10302653,31.4,2002
Hart's War,32287044,19077641,59.1,13209403,40.9,2002
Blood Work,31794718,26235081,82.5,5559637,17.5,2002
The New Guy,31167388,29760152,95.5,1407236,4.5,2002
City of God,30641770,7564459,24.7,23077311,75.3,2002
Solaris,30002758,14973382,49.9,15029376,50.1,2002
The Four Feathers,29882645,18306166,61.3,11576479,38.7,2002
City by the Sea,29414087,22449000,76.3,6965087,23.7,2002
Christmas on the Nile,29320869,0,0.0,29320869,100.0,2002
Far from Heaven,29027914,15901849,54.8,13126065,45.2,2002
Family Honor,28903789,0,0.0,28903789,100.0,2002
Brown Sugar,28316451,27363891,96.6,952560,3.4,2002
The Spanish Apartment,28193749,1067438,3.8,27126311,96.2,2002
Pokemon 4Ever: Celebi 0 Voice of the Forest,28023563,1727447,6.2,26296116,93.8,2002
The Quiet American,27674124,12988801,46.9,14685323,53.1,2002
The Crime of Padre Amaro,26996738,5717044,21.2,21279694,78.8,2002
All About the Benjamins,26306533,25916319,98.5,390214,1.5,2002
Rollerball,25852764,18990798,73.5,6861966,26.5,2002
Jonah: A VeggieTales Movie,25615231,25581229,99.9,34002,0.1,2002
The Way Home,24952738,445367,1.8,24507371,98.2,2002
Punch0Drunk Love,24665649,17844216,72.3,6821433,27.7,2002
The Guru,24128852,3095506,12.8,21033346,87.2,2002
Dark Water,24010000,0,0.0,24010000,100.0,2002
25th Hour,23928503,13084595,54.7,10843908,45.3,2002
Sex Is Zero,23915279,0,0.0,23915279,100.0,2002
Eight Crazy Nights,23833131,23586598,99.0,246533,1.0,2002
Detective Conan: The Phantom of Baker Street,23786606,0,0.0,23786606,100.0,2002
Antwone Fisher,23367586,21078145,90.2,2289441,9.8,2002
Ali G Indahouse,23280529,0,0.0,23280529,100.0,2002
Super Troopers,23182223,18492362,79.8,4689861,20.2,2002
The Legend of Al John and Jack,23039985,0,0.0,23039985,100.0,2002
Phone,21784403,0,0.0,21784403,100.0,2002
White Oleander,21672284,16357770,75.5,5314514,24.5,2002
Pok√©mon Heroes,20867919,746381,3.6,20121538,96.4,2002
Serving Sara,20146150,16930185,84.0,3215965,16.0,2002
Asterix & Obelix: Mission Cleopatra 2002 Re0release,20015611,3115188,15.6,16900423,84.4,2002
Ballistic: Ecks vs. Sever,19924033,14307963,71.8,5616070,28.2,2002
S1m0ne,19576023,9688676,49.5,9887347,50.5,2002
The Lion King 2002 IMAX Release,19486215,15686215,80.5,3800000,19.5,2002
Tuck Everlasting,19344615,19161999,99.1,182616,0.9,2002
Half Past Dead,19233280,15567860,80.9,3665420,19.1,2002
Martin Lawrence Live: Runteldat,19184820,19184820,100.0,0,0.0,2002
Feardotcom,18902015,13258249,70.1,5643766,29.9,2002
Empire,18591272,17600423,94.7,990849,5.3,2002
The Country Bears,18012097,16990825,94.3,1021272,5.7,2002
Jail Breakers,17797711,0,0.0,17797711,100.0,2002
The Last Kiss,17720347,1048950,5.9,16671397,94.1,2002
Frailty,17423030,13110448,75.2,4312582,24.8,2002
The Importance of Being Earnest,17290970,8384929,48.5,8906041,51.5,2002
Kung Pow: Enter the Fist,16994625,16037962,94.4,956663,5.6,2002
Dead Weight,16987957,0,0.0,16987957,100.0,2002
Life or Something Like It,16872671,14448589,85.6,2424082,14.4,2002
The Good Girl,16856124,14018296,83.2,2837828,16.8,2002
Femme Fatale,16838910,6630252,39.4,10208658,60.6,2002
They,16446271,12840842,78.1,3605429,21.9,2002
The Powerpuff Girls Movie,16426471,11412414,69.5,5014057,30.5,2002
The Magdalene Sisters,16373112,306989,1.9,16066123,98.1,2002
The Emperor's Club,16318449,14118751,86.5,2199698,13.5,2002
Rabbit0Proof Fence,16217411,6199600,38.2,10017811,61.8,2002
Birthday Girl,16171098,5142576,31.8,11028522,68.2,2002
To Be and to Have,16063920,777129,4.8,15286791,95.2,2002
Doraemon: Nobita and the Robot Kingdom,16053687,0,0.0,16053687,100.0,2002
Public Enemy,15897574,0,0.0,15897574,100.0,2002
Hey Arnold! The Movie,15249308,13728902,90.0,1520406,10.0,2002
Boat Trip,15020293,8600126,57.3,6420167,42.7,2002
Undisputed,14946150,12764657,85.4,2181493,14.6,2002
Possession,14815898,10113733,68.3,4702165,31.7,2002
Hollywood Ending,14569744,4850753,33.3,9718991,66.7,2002
Stealing Harvard,14277032,14036406,98.3,240626,1.7,2002
Godzilla Against Mechagodzilla,14122958,0,0.0,14122958,100.0,2002
Wet Dreams,13936317,0,0.0,13936317,100.0,2002
Dirty Pretty Things,13904766,8112414,58.3,5792352,41.7,2002
Juwanna Mann,13802599,13670733,99.0,131866,1.0,2002
Trapped,13414416,7073251,52.7,6341165,47.3,2002
Toei Spring Anime Fair,13107237,0,0.0,13107237,100.0,2002
Long Time Dead,13102295,0,0.0,13102295,100.0,2002
Knockaround Guys,12806614,11715637,91.5,1090977,8.5,2002
Narc,12633747,10465659,82.8,2168088,17.2,2002
The Other Side of the Bed,12630208,0,0.0,12630208,100.0,2002
Sorority Boys,12517488,10200032,81.5,2317456,18.5,2002
Nine Queens,12413888,1222889,9.9,11190999,90.1,2002
Abandon,12302219,10727683,87.2,1574536,12.8,2002
The Eye,12165016,512049,4.2,11652967,95.8,2002
2009: Lost Memories,12049825,0,0.0,12049825,100.0,2002
The Rules of Attraction,11819244,6532619,55.3,5286625,44.7,2002
Mohou0han,11702775,0,0.0,11702775,100.0,2002
The Order,11560806,7660806,66.3,3900000,33.7,2002
Adrenaline Rush: The Science of Risk,11011932,10994028,99.8,17904,0.2,2002
Extreme Ops,10959475,4842259,44.2,6117216,55.8,2002
Champion,10569737,0,0.0,10569737,100.0,2002
Bibi Blocksberg,10325928,0,0.0,10325928,100.0,2002
Kamen Rider Ryuki: Episode Final,10112538,0,0.0,10112538,100.0,2002
Pulse: A Stomp Odyssey,10086514,10086514,100.0,0,0.0,2002
The Lord of the Rings: The Return of the King,1140703091,377027325,33.1,763654686,66.9,2003
Finding Nemo,871014978,339714978,39.0,531300000,61.0,2003
The Matrix Reloaded,739412035,281576461,38.1,457835574,61.9,2003
Pirates of the Caribbean: The Curse of the Black Pearl,654264015,305413918,46.7,348850097,53.3,2003
Bruce Almighty,484592874,242829261,50.1,241763613,49.9,2003
The Last Samurai,454627263,111127263,24.4,343500000,75.6,2003
Terminator 3: Rise of the Machines,433371112,150371112,34.7,283000000,65.3,2003
The Matrix Revolutions,427343298,139313948,32.6,288029350,67.4,2003
X2: X0Men United,407711549,214949694,52.7,192761855,47.3,2003
Bad Boys II,273339556,138608444,50.7,134731112,49.3,2003
Something's Gotta Give,265328738,124728738,47.0,140600000,53.0,2003
Charlie's Angels: Full Throttle,259175788,100830111,38.9,158345677,61.1,2003
The Village,256697520,114197520,44.5,142500000,55.5,2003
Brother Bear,250397798,85336277,34.1,165061521,65.9,2003
Hulk,245285165,132177234,53.9,113107931,46.1,2003
Love Actually,244931766,59696144,24.4,185235622,75.6,2003
2 Fast 2 Furious,236350661,127154901,53.8,109195760,46.2,2003
American Wedding,232722935,104565114,44.9,128157821,55.1,2003
Scary Movie 3,220673217,110003217,49.8,110670000,50.2,2003
Elf,220443451,173398518,78.7,47044933,21.3,2003
Master and Commander: The Far Side of the World,211622535,93927920,44.4,117694615,55.6,2003
S.W.A.T.,207725639,116934650,56.3,90790989,43.7,2003
Spy Kids 3: Game Over,197011982,111761982,56.7,85250000,43.3,2003
Anger Management,195745823,135645823,69.3,60100000,30.7,2003
Cheaper by the Dozen,190212113,138614544,72.9,51597569,27.1,2003
The Haunted Mansion,182290266,75847266,41.6,106443000,58.4,2003
Kill Bill: Vol. 1,180899045,70099045,38.8,110800000,61.2,2003
The League of Extraordinary Gentlemen,179265204,66465204,37.1,112800000,62.9,2003
Daredevil,179179718,102543518,57.2,76636200,42.8,2003
How to Lose a Guy in 10 Days,177503042,105813373,59.6,71689014,40.4,2003
The Italian Job,176070171,106128601,60.3,69941570,39.7,2003
Cold Mountain,173013509,95636509,55.3,77377000,44.7,2003
Bringing Down the House,164729679,132716677,80.6,32013002,19.4,2003
Daddy Day Care,164433867,104297061,63.4,60136806,36.6,2003
Freaky Friday,160846332,110230332,68.5,50616000,31.5,2003
Johnny English,160466000,28082366,17.5,132383634,82.5,2003
Lara Croft: Tomb Raider 0 The Cradle of Life,160099222,65660196,41.0,94439026,59.0,2003
Mystic River,156595191,90135191,57.6,66460000,42.4,2003
Bayside Shakedown 2,155138312,0,0.0,155138312,100.0,2003
Seabiscuit,148336445,120277854,81.1,28058591,18.9,2003
Gothika,141591324,59694580,42.2,81896744,57.8,2003
Mona Lisa Smile,141337989,63860942,45.2,77477047,54.8,2003
The Jungle Book 2,135703599,47901582,35.3,87802017,64.7,2003
The Cat in the Hat,133960541,101149285,75.5,32811256,24.5,2003
School of Rock,131095614,81261177,62.0,49834437,38.0,2003
Legally Blonde 2: Red White & Blonde,124914842,90186328,72.2,34728514,27.8,2003
Big Fish,123218424,66809693,54.2,56408731,45.8,2003
Peter Pan,121975011,48462608,39.7,73512403,60.3,2003
Intolerable Cruelty,120801243,35327628,29.2,85473615,70.8,2003
Lost in Translation,118685453,44585453,37.6,74100000,62.4,2003
Paycheck,117248958,53790451,45.9,63458507,54.1,2003
Freddy vs. Jason,116632628,82622655,70.8,34009973,29.2,2003
The Texas Chainsaw Massacre,107071655,80571655,75.3,26500000,24.7,2003
Just Married,101564935,56127162,55.3,45437773,44.7,2003
The Recruit,101191884,52802140,52.2,48389744,47.8,2003
Once Upon a Time in Mexico,98096026,56359780,57.5,41736246,42.5,2003
Phone Booth,97837138,46566212,47.6,51270926,52.4,2003
Underworld,95708457,51970690,54.3,43737767,45.7,2003
Calendar Girls,93400759,31041759,33.2,62359000,66.8,2003
Final Destination 2,90941129,46961214,51.6,43979915,48.4,2003
Identity,90259536,52159536,57.8,38100000,42.2,2003
Kangaroo Jack,88929111,66934963,75.3,21994148,24.7,2003
Shanghai Knights,88323487,60476872,68.5,27846615,31.5,2003
Old School,87135520,75585093,86.7,11550427,13.3,2003
Tears of the Sun,86468162,43734876,50.6,42733286,49.4,2003
Sinbad: Legend of the Seven Seas,80773077,26483452,32.8,54289625,67.2,2003
The Rundown,80657921,47726342,59.2,32931579,40.8,2003
Runaway Jury,80154140,49443628,61.7,30710512,38.3,2003
Good Bye Lenin!,79316957,4064200,5.1,75252757,94.9,2003
Bad Santa,76488889,60060328,78.5,16428561,21.5,2003
Dreamcatcher,75715436,33715436,44.5,42000000,55.5,2003
The Core,73498611,31186896,42.4,42311715,57.6,2003
Holes,71406573,67406573,94.4,4000000,5.6,2003
Looney Tunes: Back in Action,68514844,20991364,30.6,47523480,69.4,2003
Open Range,68296293,58331254,85.4,9965039,14.6,2003
Stuck on You,65784503,33832741,51.4,31951762,48.6,2003
Matchstick Men,65565672,36906460,56.3,28659212,43.7,2003
Taxi 3,65497208,497208,0.8,65000000,99.2,2003
Jeepers Creepers 2,63102666,35667218,56.5,27435448,43.5,2003
Piglet's Big Movie,62870546,23103423,36.7,39767123,63.3,2003
Honey,62228395,30308417,48.7,31919978,51.3,2003
21 Grams,60427839,16290476,27.0,44137363,73.0,2003
Under the Tuscan Sun,58878723,43610723,74.1,15268000,25.9,2003
Agent Cody Banks,58795814,47938330,81.5,10857484,18.5,2003
Monster,58469210,34469210,59.0,24000000,41.0,2003
Cradle 2 the Grave,56489558,34712347,61.4,21777211,38.6,2003
The Lizzie McGuire Movie,55534455,42734455,77.0,12800000,23.0,2003
Out of Time,55495563,41088845,74.0,14406718,26.0,2003
Rugrats Go Wild,55250496,39402572,71.3,15847924,28.7,2003
Radio,53293628,52333738,98.2,959890,1.8,2003
Hollywood Homicide,51142659,30940691,60.5,20201968,39.5,2003
What a Girl Wants,50732139,36105433,71.2,14626706,28.8,2003
The Jungle Book 2 2003 Re0release,50600160,0,0.0,50600160,100.0,2003
National Security,50097949,36381186,72.6,13716763,27.4,2003
Secondhand Lions,48249017,42070939,87.2,6178078,12.8,2003
Darkness Falls,47488536,32551396,68.5,14937140,31.5,2003
Torque,46546197,21215059,45.6,25331138,54.4,2003
The Hunted,46061847,34244097,74.3,11817750,25.7,2003
Good Boy,45312217,37667746,83.1,7644471,16.9,2003
Uptown Girls,44617342,37182494,83.3,7434848,16.7,2003
A Man Apart,44350926,26736098,60.3,17614828,39.7,2003
Timeline,43935763,19481943,44.3,24453820,55.7,2003
Basic,42792561,26793311,62.6,15999250,37.4,2003
Whale Rider,41062976,20779666,50.6,20283310,49.4,2003
Down with Love,39468111,20305251,51.4,19162860,48.6,2003
Dumb and Dumberer: When Harry Met Lloyd,39267515,26276465,66.9,12991050,33.1,2003
The Life of David Gale,38955598,19955598,51.2,19000000,48.8,2003
Head of State,38620484,38125247,98.7,495237,1.3,2003
The Missing,38364277,27011180,70.4,11353097,29.6,2003
Bulletproof Monk,37713879,23358708,61.9,14355171,38.1,2003
Malibu's Most Wanted,34622504,34432201,99.5,190303,0.5,2003
The Medallion,34268701,22219192,64.8,12049509,35.2,2003
The Fighting Temptations,33972062,30250745,89.0,3721317,11.0,2003
Pok√©mon: Jirachi 0 Wish Maker,33393751,0,0.0,33393751,100.0,2003
Girl with a Pearl Earring,33030115,11670971,35.3,21359144,64.7,2003
Suddenly Paradise,31679869,0,0.0,31679869,100.0,2003
The Blind Swordsman: Zatoichi,31167430,0,0.0,31167430,100.0,2003
Cabin Fever,30553394,21158188,69.2,9395206,30.8,2003
Laws of Attraction,30031874,17871255,59.5,12160619,40.5,2003
Luther,29413900,5791328,19.7,23622572,80.3,2003
Bugs!,29388999,19063544,64.9,10325455,35.1,2003
Cold Creek Manor,29119434,21386011,73.4,7733423,26.6,2003
Wrong Turn,28650575,15418790,53.8,13231785,46.2,2003
Ruby & Quentin,27720972,312824,1.1,27408148,98.9,2003
The In0Laws,26891849,20453431,76.1,6438418,23.9,2003
In America,25382911,15539656,61.2,9843255,38.8,2003
The Miracle of Bern,24816750,0,0.0,24816394,100.0,2003
Detective Conan: Crossroad in the Ancient Capital,24342320,0,0.0,24342320,100.0,2003
Mortadelo & Filemon: The Big Adventure,23920411,0,0.0,23920411,100.0,2003
Dickie Roberts: Former Child Star,23769505,22738671,95.7,1030834,4.3,2003
In the Cut,23726793,4750602,20.0,18976191,80.0,2003
Biker Boyz,23510621,22076772,93.9,1433849,6.1,2003
Yomigaeri,23259542,0,0.0,23259542,100.0,2003
Confidence,23014206,12251640,53.2,10762566,46.8,2003
The Human Stain,22954068,5381908,23.4,17572160,76.6,2003
Swimming Pool,22441497,10130108,45.1,12311389,54.9,2003
Chouchou,22288364,0,0.0,22288364,100.0,2003
Ghosts of the Abyss,22141539,17040871,77.0,5100668,23.0,2003
Love Don't Cost a Thing,21964072,21924226,99.8,39846,0.2,2003
The Barbarian Invasions 2003 Re0release,21815430,3435749,15.7,18379681,84.3,2003
Doraemon: Nobita and the Wind Wizard,20428491,0,0.0,20428491,100.0,2003
Ong0Bak: The Thai Warrior,20235426,4563167,22.6,15672259,77.4,2003
View from the Top,19526014,15614000,80.0,3912014,20.0,2003
Duplex,19322135,9692135,50.2,9630000,49.8,2003
Deep Blue,19288261,132261,0.7,19156000,99.3,2003
A Mighty Wind,18750246,17781006,94.8,969240,5.2,2003
My Boss's Daughter,18191005,15550605,85.5,2640400,14.5,2003
My Tutor Friend,17896209,0,0.0,17896209,100.0,2003
The New World,17823920,0,0.0,17823920,100.0,2003
Deliver Us from Eva,17573594,17573594,100.0,0,0.0,2003
A Guy Thing,17432163,15545431,89.2,1886732,10.8,2003
Would I Lie to You? 2,17317084,0,0.0,17317084,100.0,2003
House of 1000 Corpses,16829545,12634962,75.1,4194583,24.9,2003
House of Sand and Fog,16763804,13040288,77.8,3723516,22.2,2003
Dogville,16680836,1535286,9.2,15145550,90.8,2003
Facing Windows,15530077,543354,3.5,14986723,96.5,2003
Zelary,15461305,330033,2.1,15131272,97.9,2003
Alex & Emma,15368897,14218698,92.5,1150199,7.5,2003
The Dreamers,15121165,2532228,16.7,12588937,83.3,2003
Oldboy,14980005,707481,4.7,14272524,95.3,2003
Battle Royale II,14899584,0,0.0,14899584,100.0,2003
One Piece: Dead End Adventure,14817006,0,0.0,14817006,100.0,2003
The Triplets of Belleville,14776760,7007149,47.4,7769611,52.6,2003
Together with You,14687167,1151941,7.8,13535226,92.2,2003
How to Deal,14390329,14195227,98.6,195102,1.4,2003
Football Days,14117202,0,0.0,14117202,100.0,2003
Touching the Void,13885802,4593598,33.1,9292204,66.9,2003
House of the Dead,13818181,10249719,74.2,3568462,25.8,2003
Anything Else,13585075,3212310,23.6,10372765,76.4,2003
Kal Ho Naa Ho,13200241,1991922,15.1,11208319,84.9,2003
The Barbarian Invasions,13065317,5109226,39.1,7956091,60.9,2003
Onmyoji 2,13022862,0,0.0,13022862,100.0,2003
The Divorce,12991996,9081057,69.9,3910939,30.1,2003
Gods and Generals,12923936,12882934,99.7,41002,0.3,2003
Remember Me My Love,12671306,227986,1.8,12443320,98.2,2003
Chasing Papi,12661189,6130049,48.4,6531140,51.6,2003
Winged Migration 2003 Re0release,12634963,10764402,85.2,1870561,14.8,2003
Seducing Doctor Lewis,12504038,9354342,74.8,3149696,25.2,2003
Monsieur Ibrahim,12364836,2823890,22.8,9540946,77.2,2003
Koi... Mil Gaya,12168232,671372,5.5,11496860,94.5,2003
Dark Blue,12150301,9250301,76.1,2900000,23.9,2003
Beyond Borders,11705002,4430101,37.8,7274901,62.2,2003
The Dope,11289473,0,0.0,11289473,100.0,2003
Kamen Rider 555: Paradise Lost,11067556,0,0.0,11067556,100.0,2003
Godzilla: Tokyo S.O.S.,10724345,0,0.0,10724345,100.0,2003
The Cooler,10464788,8291572,79.2,2173216,20.8,2003
A Touch of Spice,10395779,0,0.0,10395779,100.0,2003
Thirteen,10128960,4601043,45.4,5527917,54.6,2003
Kisarazu Cat's Eye: Nihon Series,10029866,0,0.0,10029866,100.0,2003
Elephant,10012022,1266955,12.7,8745067,87.3,2003
Shin Chan: The Adult Empire Strikes Back,9851449,0,0.0,9851449,100.0,2003
My Life Without Me,9726954,400948,4.1,9326006,95.9,2003
The Young Black Stallion,9638389,6751389,70.0,2887000,30.0,2003
Married for 7 Years,9545175,0,0.0,9545175,100.0,2003
Veronica Guerin,9439660,1571504,16.6,7868156,83.4,2003
The Flying Classroom,9378807,0,0.0,9378807,100.0,2003
Apr√®s Vous,8852763,830292,9.4,8022471,90.6,2003
Spring Summer Fall Winter... and Spring,8841920,2380788,26.9,6461132,73.1,2003
18 Years Later,8785730,25611,0.3,8760119,99.7,2003
Le coeur des hommes,8755325,0,0.0,8755325,100.0,2003
Shrek 2,928965969,441426807,47.5,487534523,52.5,2004
Harry Potter and the Prisoner of Azkaban,795634069,249541069,31.4,546093000,68.6,2004
Spider0Man 2,783766341,373585825,47.7,410180516,52.3,2004
The Incredibles,631442092,261441092,41.4,370001000,58.6,2004
The Passion of the Christ,611490759,370274604,60.6,241212132,39.4,2004
The Day After Tomorrow,552639571,186740799,33.8,365898772,66.2,2004
Meet the Fockers,522657936,279261160,53.4,243396776,46.6,2004
Troy,497409852,133378256,26.8,364031596,73.2,2004
Shark Tale,374583879,160861908,42.9,213721971,57.1,2004
Ocean's Twelve,362744280,125544280,34.6,237200000,65.4,2004
I Robot,353133898,144801023,41.0,208332875,59.0,2004
National Treasure,347512318,173008894,49.8,174503424,50.2,2004
Van Helsing,300157638,120177084,40.0,179980554,60.0,2004
The Bourne Supremacy,290633422,176241941,60.6,114391481,39.4,2004
The Polar Express,286000505,162775358,56.9,123225147,43.1,2004
Bridget Jones: The Edge of Reason,265126918,40226215,15.2,224900703,84.8,2004
Howl's Moving Castle,235204375,4711096,2.0,230484947,98.0,2004
Fahrenheit 9/11,222446882,119194771,53.6,103252111,46.4,2004
Collateral,220239925,101005703,45.9,119234222,54.1,2004
The Terminal,218685607,77872883,35.6,140812724,64.4,2004
Million Dollar Baby,216763646,100492203,46.4,116271443,53.6,2004
The Aviator,213719942,102610330,48.0,111109612,52.0,2004
A Series of Unfortunate Events,211468235,118634549,56.1,92833686,43.9,2004
King Arthur,203567857,51882244,25.5,151685613,74.5,2004
Garfield: The Movie,203172417,75369589,37.1,127802828,62.9,2004
50 First Dates,198413428,120908074,60.9,77505354,39.1,2004
The Grudge,187281115,110359362,58.9,76921753,41.1,2004
Scooby0Doo 2: Monsters Unleashed,181216833,84216833,46.5,97000000,53.5,2004
Along Came Polly,178311729,88097164,49.4,90214565,50.6,2004
Alien vs. Predator,177427090,80282231,45.2,97144859,54.8,2004
Starsky & Hutch,170268750,88237754,51.8,82030996,48.2,2004
Shall We Dance?,170128460,57890460,34.0,112238000,66.0,2004
Dodgeball: A True Underdog Story,168423227,114326736,67.9,54096491,32.1,2004
Alexander,167298192,34297191,20.5,133001001,79.5,2004
The Phantom of the Opera,154648887,51268815,33.2,103380072,66.8,2004
Kill Bill: Vol. 2,154116796,66208183,43.0,87908613,57.0,2004
Home on the Range,145358062,50030461,34.4,95327601,65.6,2004
The SpongeBob SquarePants Movie,140192993,85417988,60.9,54775005,39.1,2004
The Princess Diaries 2: Royal Engagement,134734481,95170481,70.6,39564000,29.4,2004
Blade: Trinity,131883935,52411906,39.7,79472029,60.3,2004
Man on Fire,130834852,77911774,59.5,52923078,40.5,2004
Mean Girls,130135039,86058055,66.1,44067774,33.9,2004
Resident Evil: Apocalypse,129342769,51201453,39.6,78141316,60.4,2004
Ray,123971376,75331600,60.8,48639776,39.2,2004
The Notebook,117814972,81001787,68.8,36810836,31.2,2004
The Forgotten,117592831,67133509,57.1,50459322,42.9,2004
Finding Neverland,116650613,51680613,44.3,64970000,55.7,2004
The Chronicles of Riddick,115900534,57761012,49.8,58139522,50.2,2004
Closer,115505027,33987757,29.4,81517270,70.6,2004
White Chicks,113086475,70831760,62.6,42254715,37.4,2004
Sideways,109706931,71503593,65.2,38203338,34.8,2004
Hidalgo,108040622,67303450,62.3,40737172,37.7,2004
The Stepford Wives,103370127,59484742,57.5,43885385,42.5,2004
Saw,103096345,55185045,53.5,47911300,46.5,2004
Dawn of the Dead,102278712,59020957,57.7,43257755,42.3,2004
Kung Fu Hustle,100912445,17108591,17.0,83803854,83.0,2004
Ladder 49,100572044,74541707,74.1,26030337,25.9,2004
Hellboy,99318987,59623958,60.0,39695029,40.0,2004
The Butterfly Effect,96693417,57938693,59.9,38754724,40.1,2004
Christmas with the Kranks,96572480,73780539,76.4,22791941,23.6,2004
13 Going on 30,96455697,57231747,59.3,39223950,40.7,2004
The Manchurian Candidate,96105910,65955630,68.6,30150280,31.4,2004
Secret Window,92913171,48022900,51.7,44890271,48.3,2004
House of Flying Daggers,92863945,11050094,11.9,81813851,88.1,2004
Downfall,92181574,5509040,6.0,86672534,94.0,2004
Anchorman: The Legend of Ron Burgundy,90650045,85288303,94.1,5361427,5.9,2004
Catwoman,82402379,40202379,48.8,42200000,51.2,2004
The Chorus,82032134,2087128,2.5,79945006,97.5,2004
Exorcist: The Beginning,78110021,41821986,53.5,36288035,46.5,2004
The Ladykillers,76665191,39799191,51.9,36866000,48.1,2004
(T)Raumschiff Surprise 0 Periode 1,76341401,0,0.0,76341401,100.0,2004
Crying Out Love in the Center of the World,73611055,0,0.0,73611055,100.0,2004
Eternal Sunshine of the Spotless Mind,73389931,34400301,46.9,38987433,53.1,2004
Without a Paddle,73029190,58169327,79.7,14859863,20.3,2004
Around the World in 80 Days,72178895,24008137,33.3,48170758,66.7,2004
Anacondas: The Hunt for the Blood Orchid,70992898,32238923,45.4,38753975,54.6,2004
Taxi 2004 Re0release,70778329,36611066,51.7,34167263,48.3,2004
A Cinderella Story,70080371,51438175,73.4,18629734,26.6,2004
Tae Guk Gi: The Brotherhood of War,69827583,1111061,1.6,68716522,98.4,2004
A Very Long Engagement,69424389,6524389,9.4,62900000,90.6,2004
Barbershop 2: Back in Business,65991448,65111277,98.7,880171,1.3,2004
Taking Lives,65470529,32682342,49.9,32788187,50.1,2004
Miracle,64445708,64378093,99.9,67615,0.1,2004
After the Sunset,62657868,28331233,45.2,34326635,54.8,2004
Two Brothers,62172050,19176754,30.8,42995296,69.2,2004
Friday Night Lights,61950770,61255921,98.9,694849,1.1,2004
In Good Company,61315215,45806659,74.7,15508556,25.3,2004
Sky Captain and the World of Tomorrow,57947036,37762677,65.2,20184359,34.8,2004
Cellular,57678321,32003620,55.5,25674701,44.5,2004
The Motorcycle Diaries,57663224,16781387,29.1,40881837,70.9,2004
Seven Dwarves,57410311,0,0.0,57410311,100.0,2004
Walking Tall,57223890,46437717,81.2,10786173,18.8,2004
Spanglish,55470154,42726869,77.0,12743285,23.0,2004
The Punisher,54700105,33810189,61.8,20889916,38.2,2004
Open Water,54683487,30610863,56.0,24072624,44.0,2004
Team America: World Police,50826898,32786074,64.5,18040824,35.5,2004
You Got Served,50576805,40363810,79.8,10212995,20.2,2004
Raising Helen,49718611,37486512,75.4,12232099,24.6,2004
Fat Albert,48551322,48116322,99.1,435000,0.9,2004
Be with You,46616207,0,0.0,46616207,100.0,2004
Napoleon Dynamite,46118097,44540956,96.6,1577141,3.4,2004
The Sea Inside,43685449,2104923,4.8,41580526,95.2,2004
Wimbledon,41682237,17001133,40.8,24681104,59.2,2004
Twisted,40954603,25198598,61.5,15756005,38.5,2004
Bad Education,40350837,5211842,12.9,35138995,87.1,2004
Crimson Rivers 2: Angels of the Apocalypse,40152148,152148,0.4,40000000,99.6,2004
The Prince and Me,37666766,28176497,74.8,9490269,25.2,2004
Garden State,35825316,26782316,74.8,9043000,25.2,2004
Jersey Girl,35492921,25268157,71.2,10224764,28.8,2004
Alfie,35060882,13399812,38.2,21661070,61.8,2004
Flight of the Phoenix,35021497,21009180,60.0,14012317,40.0,2004
The Life Aquatic with Steve Zissou,34808403,24020403,69.0,10788000,31.0,2004
Pok√©mon the Movie: Destiny Deoxys,34337258,0,0.0,34337258,100.0,2004
Hotel Rwanda,33882243,23530892,69.4,10351351,30.6,2004
Confessions of a Teenage Drama Queen,33251890,29331068,88.2,3920822,11.8,2004
Night Watch,32396890,0,0.0,32396890,100.0,2004
Johnson Family Vacation,31326183,31203964,99.6,122219,0.4,2004
The Girl Next Door,30381722,14589444,48.0,15792278,52.0,2004
Godsend,30120671,14379751,47.7,15740920,52.3,2004
Shaun of the Dead,30039392,13542874,45.1,16496518,54.9,2004
Yu0Gi0Oh!: The Movie 0 Pyramid of Light,29144802,19765868,67.8,9378934,32.2,2004
Agent Cody Banks 2: Destination London,28818995,23630159,82.0,5188836,18.0,2004
Thunderbirds,28283637,6880917,24.3,21402720,75.7,2004
Dirty Dancing: Havana Nights,27685016,14161590,51.2,13523426,48.8,2004
Ella Enchanted,27388767,22918387,83.7,4470380,16.3,2004
Doraemon: Nobita in the Wan0Nyan Spacetime Odyssey,26663978,0,0.0,26663978,100.0,2004
The Whole Ten Yards,26170671,16328471,62.4,9842200,37.6,2004
The Alamo,25819961,22414961,86.8,3405000,13.2,2004
Seed of Chucky,24829644,17083732,68.8,7745912,31.2,2004
Bride & Prejudice,24716440,6605592,26.7,18110848,73.3,2004
Podium,24511116,0,0.0,24511116,100.0,2004
Harold & Kumar Go to White Castle,23936908,18250550,76.2,5686358,23.8,2004
Birth,23925492,5095038,21.3,18830454,78.7,2004
Christmas in Love,22668087,0,0.0,22668087,100.0,2004
Detective Conan: Magician of the Silver Sky,22618511,0,0.0,22618511,100.0,2004
EuroTrip,22605153,17771387,78.6,4833766,21.4,2004
Quill: The Life of a Guide Dog,22298559,0,0.0,22298559,100.0,2004
NASCAR: The IMAX Experience,22248831,21583831,97.0,665000,3.0,2004
Little Black Book,22035509,20698668,93.9,1336841,6.1,2004
Do You Know Claudia?,21852972,0,0.0,21852972,100.0,2004
Mr. 3000,21839377,21811187,99.9,28190,0.1,2004
Wicker Park,21568818,13001257,60.3,8567561,39.7,2004
Win a Date with Tad Hamilton!,21513434,17071962,79.4,4441472,20.6,2004
The Merchant of Venice,21417725,3765585,17.6,17652140,82.4,2004
New York Minute,21289826,14071441,66.1,7218385,33.9,2004
Mindhunters,21148829,4480744,21.2,16668085,78.8,2004
G.O.R.A.,20839049,0,0.0,20839049,100.0,2004
Super Size Me,20645757,11536423,55.9,9109334,44.1,2004
The 11 Commandments,20537839,0,0.0,20537839,100.0,2004
Ladies in Lavender,20377075,6765081,33.2,13611994,66.8,2004
Melinda and Melinda,20129327,3826280,19.0,16303047,81.0,2004
I Heart Huckabees,20072172,12785432,63.7,7286740,36.3,2004
2046,19470239,1444588,7.4,18025651,92.6,2004
Vanity Fair,19463185,16136476,82.9,3326709,17.1,2004
Windstruck,19225992,0,0.0,19225992,100.0,2004
The Corsican File,18922216,0,0.0,18922216,100.0,2004
Swing Girls,18758613,0,0.0,18758613,100.0,2004
Look at Me,18729751,1737308,9.3,16992443,90.7,2004
De0Lovely,18611951,13456633,72.3,5155318,27.7,2004
My Baby's Daddy,18490423,17669317,95.6,821106,4.4,2004
Quai des illusions,18291248,0,0.0,18291248,100.0,2004
Kinsey,17050017,10254979,60.1,6795038,39.9,2004
Catch That Kid,16951702,16703799,98.5,247903,1.5,2004
Paparazzi,16796512,15714234,93.6,1082278,6.4,2004
One Missed Call,16367880,0,0.0,16367880,100.0,2004
Nin x Nin: Ninja Hattori0kun the Movie,16351134,0,0.0,16351134,100.0,2004
What the #*! Do We (K)now!?,15998178,10942306,68.4,5055872,31.6,2004
Before Sunset,15854307,5820649,36.7,10029110,63.3,2004
Lucky Luke and the Daltons,15823762,0,0.0,15823762,100.0,2004
Surviving Christmas,15125687,11663156,77.1,3462531,22.9,2004
The Last Trapper,14905929,0,0.0,14905929,100.0,2004
Raise Your Voice,14867514,10411980,70.0,4455534,30.0,2004
Soul Plane,14821824,14190750,95.7,631074,4.3,2004
Half a Confession,14638660,0,0.0,14638660,100.0,2004
Welcome to Mooseport,14615099,14470947,99.0,144152,1.0,2004
Envy,14494036,13562325,93.6,931711,6.4,2004
Being Julia,14339171,7739049,54.0,6600122,46.0,2004
Vizontele Tuuba,13954476,0,0.0,13954476,100.0,2004
French Spies,13844465,0,0.0,13844465,100.0,2004
Der Wixxer,13607165,0,0.0,13607165,100.0,2004
One Piece: The Cursed Holy Sword,13422333,0,0.0,13422333,100.0,2004
Umizaru,13361623,0,0.0,13361623,100.0,2004
RRRrrrr!!!,13315054,54361,0.4,13260693,99.6,2004
Vera Drake,13267869,3775283,28.5,9492586,71.5,2004
Mariages!,12991310,0,0.0,12991310,100.0,2004
Maria Full of Grace,12594630,6529624,51.8,6065006,48.2,2004
Breakin' All the Rules,12544254,12264319,97.8,279935,2.2,2004
The Clearing,12520799,5763875,46.0,6756924,54.0,2004
Casshern,12353768,0,0.0,12353768,100.0,2004
Chasing Liberty,12313323,12195626,99.0,117697,1.0,2004
Don't Move,12071007,337265,2.8,11733742,97.2,2004
Kureyon Shin0chan 2004 Re0release,12066375,0,0.0,12066375,100.0,2004
The Cookout,12009070,11814019,98.4,195051,1.6,2004
Layer Cake,11850214,2339957,19.7,9510257,80.3,2004
Suspect Zero,11416075,8725813,76.4,2690262,23.6,2004
Connie and Carla,11341016,8085771,71.3,3255245,28.7,2004
Naruto the Movie: Ninja Clash in the Land of Snow,11141307,0,0.0,11141307,100.0,2004
Head0On,11030861,435395,3.9,10595466,96.1,2004
District B13,10976892,1200216,10.9,9776676,89.1,2004
The Perfect Score,10898337,10391003,95.3,507334,4.7,2004
Harry Potter and the Goblet of Fire,895921036,290013036,32.4,605908000,67.6,2005
Star Wars: Episode III 0 Revenge of the Sith,868352530,380270577,43.8,488081953,56.2,2005
The Chronicles of Narnia: The Lion the Witch and the Wardrobe,745013115,291710957,39.2,453302158,60.8,2005
War of the Worlds,603873119,234280354,38.8,369592765,61.2,2005
King Kong,556906378,218080025,39.2,338826353,60.8,2005
Madagascar,542063846,193595521,35.7,348468325,64.3,2005
Mr. & Mrs. Smith,487287646,186336279,38.2,300951367,61.8,2005
Charlie and the Chocolate Factory,474968763,206459076,43.5,268509687,56.5,2005
Batman Begins,373443774,205343774,55.0,168100000,45.0,2005
Hitch,371594210,179495555,48.3,192098655,51.7,2005
Fantastic Four,333535934,154696080,46.4,178839854,53.6,2005
Chicken Little,314432837,135386665,43.1,179046172,56.9,2005
Wedding Crashers,288467645,209255921,72.5,79211724,27.5,2005
Robots,262511490,128200012,48.8,134311478,51.2,2005
Constantine,230884728,75976178,32.9,154908550,67.1,2005
Flightplan,223387299,89707299,40.2,133680000,59.8,2005
Kingdom of Heaven,218122627,47398413,21.7,170724214,78.3,2005
Fun with Dick and Jane,204681899,110332737,53.9,94349162,46.1,2005
The Pacifier,198636868,113086868,56.9,85550000,43.1,2005
Wallace & Gromit: The Curse of the Were0Rabbit,192614977,56110897,29.1,136504080,70.9,2005
The Longest Yard,191466556,158119460,82.6,33347096,17.4,2005
Walk the Line,186797986,119519402,64.0,67278584,36.0,2005
Brokeback Mountain,178062759,83043761,46.6,95018998,53.4,2005
The 400Year0Old Virgin,177378645,109449237,61.7,67929408,38.3,2005
The Ring Two,163995949,76231249,46.5,87764700,53.5,2005
The Island,162949164,35818913,22.0,127130251,78.0,2005
The Interpreter,162944923,72708161,44.6,90236762,55.4,2005
Memoirs of a Geisha,162242962,57490508,35.4,104752454,64.6,2005
Sin City,158733820,74103820,46.7,84630000,53.3,2005
Monster0in0Law,155457327,82931301,53.3,72526026,46.7,2005
Saw II,147748505,87039965,58.9,60708540,41.1,2005
The Exorcism of Emily Rose,145166804,75072454,51.7,70094350,48.3,2005
Herbie Fully Loaded,144146816,66023816,45.8,78123000,54.2,2005
The Legend of Zorro,142400065,46464023,32.6,95936042,67.4,2005
Bewitched,131426169,63313159,48.2,68113010,51.8,2005
Munich,130982129,47403685,36.2,83578444,63.8,2005
Cheaper by the Dozen 2,130154568,82571173,63.4,47583395,36.6,2005
March of the Penguins,127392693,77437223,60.8,49955470,39.2,2005
Nanny McPhee,123276807,47144110,38.2,76132697,61.8,2005
Hide and Seek,123204920,51100486,41.5,72104434,58.5,2005
Pride & Prejudice,121616555,38405088,31.6,83211467,68.4,2005
Sahara,119240351,68671925,57.6,50568426,42.4,2005
Corpse Bride,118090836,53359111,45.2,64731725,54.8,2005
The Dukes of Hazzard,111069515,80270227,72.3,30799288,27.7,2005
Hoodwinked!,110013167,51386611,46.7,58626556,53.3,2005
Cinderella Man,108539911,61649911,56.8,46890000,43.2,2005
The Amityville Horror,107516369,65233369,60.7,42283000,39.3,2005
The Brothers Grimm,105316267,37916267,36.0,67400000,64.0,2005
The Hitchhiker's Guide to the Galaxy,104478416,51085416,48.9,53393000,51.1,2005
Guess Who,103121466,68915888,66.8,34205578,33.2,2005
Just Like Heaven,102854431,48318130,47.0,54536301,53.0,2005
Miss Congeniality 2: Armed & Fabulous,101393569,48478006,47.8,52915563,52.2,2005
Crash,98410061,54580300,55.5,43829761,44.5,2005
Are We There Yet?,97918663,82674398,84.4,15244265,15.6,2005
Jarhead,97076152,62658220,64.5,34417932,35.5,2005
Red Eye,96258201,57891803,60.1,38366398,39.9,2005
Be Cool,95763716,56046979,58.5,39716737,41.5,2005
The Skeleton Key,93983911,47907715,51.0,46076196,49.0,2005
Syriana,93974620,50824620,54.1,43150000,45.9,2005
The Family Stone,92884429,60062868,64.7,32821561,35.3,2005
Four Brothers,92374674,74494381,80.6,17880293,19.4,2005
White Noise,91196419,56386759,61.8,34809660,38.2,2005
Racing Stripes,90754475,49772522,54.8,40981953,45.2,2005
Transporter 2,89083229,43095856,48.4,45987373,51.6,2005
Rumor Has It...,88933562,43000262,48.4,45933300,51.6,2005
Sky High,86369815,63946815,74.0,22423000,26.0,2005
Match Point,85638656,23151529,27.0,62487127,73.0,2005
In Her Shoes,83697473,32880591,39.3,50816882,60.7,2005
The Constant Gardener,82466670,33579797,40.7,48886873,59.3,2005
Stealth,79268322,32116746,40.5,47151576,59.5,2005
Hostage,77608617,34639939,44.6,42968678,55.4,2005
Coach Carter,76669554,67264877,87.7,9404677,12.3,2005
The King and the Clown,74466867,0,0.0,74466867,100.0,2005
Yours Mine & Ours,72662923,53412862,73.5,19250061,26.5,2005
Lord of War,72617068,24149632,33.3,48467436,66.7,2005
The Adventures of Sharkboy and Lavagirl 30D,71992655,39177684,54.4,32814971,45.6,2005
xXx: State of the Union,71410636,26873932,37.6,44536704,62.4,2005
House of Wax,68766121,32064800,46.6,36701321,53.4,2005
Prime,67937494,22827153,33.6,45110341,66.4,2005
Boogeyman,67192859,46752382,69.6,20440477,30.4,2005
Zathura: A Space Adventure,65079236,29258869,45.0,35820235,55.0,2005
Valiant,61746888,19478106,31.5,42268782,68.5,2005
A History of Violence,61385065,31504633,51.3,29880432,48.7,2005
Son of the Mask,59981548,17018422,28.4,42963126,71.6,2005
Must Love Dogs,58231520,43894863,75.4,14336657,24.6,2005
Doom,58072119,28212337,48.6,29859782,51.4,2005
Derailed,57479076,36024076,62.7,21455000,37.3,2005
The Descent,57051053,26024456,45.6,31026597,54.4,2005
Elektra,56995646,24409722,42.8,32585924,57.2,2005
Kicking & Screaming,56070433,52842724,94.2,3227709,5.8,2005
Good Night and Good Luck.,54641191,31558003,57.8,23083188,42.2,2005
√Üon Flux,53321673,25874337,48.5,27447336,51.5,2005
Pooh's Heffalump Movie,52858433,18098433,34.2,34760000,65.8,2005
Elizabethtown,52164016,26850426,51.5,25313590,48.5,2005
Just Friends,50912434,32619671,64.1,18292763,35.9,2005
Unleashed,50871113,24537621,48.2,26333492,51.8,2005
Diary of a Mad Black Woman,50652203,50633099,100.0,19104,0.1,2005
Fever Pitch,50605163,42071069,83.1,8534094,16.9,2005
Capote,49327405,28750530,58.3,20576875,41.7,2005
Broken Flowers,47329961,13744960,29.0,33585001,71.0,2005
The Wedding Date,47096206,31726995,67.4,15369211,32.6,2005
Land of the Dead,47074133,20700082,44.0,26374051,56.0,2005
Get Rich or Die Tryin',46563961,30985352,66.5,15578609,33.5,2005
The Fog,46201432,29550869,64.0,16650563,36.0,2005
Into the Blue,46117696,18801234,40.8,27316462,59.2,2005
Deuce Bigalow: European Gigolo,45109561,22400154,49.7,22709407,50.3,2005
Dark Water 2005 Re0release,44347079,25473352,57.4,18873727,42.6,2005
A Lot Like Love,42886719,21845719,50.9,21041000,49.1,2005
Oliver Twist,42580321,2080321,4.9,40500000,95.1,2005
The Sisterhood of the Traveling Pants,42013878,39053061,93.0,2960817,7.0,2005
Serenity,40445129,25514517,63.1,14930612,36.9,2005
The Ringer,40442443,35428675,87.6,5013768,12.4,2005
Magnificent Desolation: Walking on the Moon,40339402,34137524,84.6,6201878,15.4,2005
Yamato,39287114,0,0.0,39287114,100.0,2005
Dreamer,38741732,32751093,84.5,5990639,15.5,2005
Always: Sunset on Third Street,38573583,0,0.0,38573583,100.0,2005
The Producers,38075318,19398532,50.9,18676786,49.1,2005
Casanova,37691644,11304403,30.0,26387241,70.0,2005
Beauty Shop,37245453,36351350,97.6,894103,2.4,2005
Pok√©mon: Lucario and the Mystery of Mew,37228626,0,0.0,37228626,100.0,2005
Negotiator: Mashita Masayoshi,36733286,0,0.0,36733286,100.0,2005
Assault on Precinct 13,35294470,20040895,56.8,15253575,43.2,2005
Nana,34671042,0,0.0,34671042,100.0,2005
Wild Safari 0 A South African Adventure,34257135,16621530,48.5,17635605,51.5,2005
Bad News Bears,34252847,32868349,96.0,1384498,4.0,2005
Because of Winn0Dixie,33589427,32647042,97.2,942385,2.8,2005
The Cave,33296457,15007991,45.1,18288466,54.9,2005
Marathon,33284089,0,0.0,33284089,100.0,2005
The Brice Man,33026616,0,0.0,33026616,100.0,2005
Cry Wolf,32586408,10047674,30.8,22538734,69.2,2005
The Suspect: Muroi Shinji,32104229,0,0.0,32104229,100.0,2005
Marrying the Mafia 2: Enemy0in0Law,31835989,0,0.0,31835989,100.0,2005
Welcome to Dongmakgol,31787130,0,0.0,31787130,100.0,2005
Rent,31670620,29077547,91.8,2593073,8.2,2005
The New World 2005 Re0release,31510855,12712093,40.3,18798762,59.7,2005
Train Man,31090100,0,0.0,31090100,100.0,2005
The Promise,30925693,669625,2.2,30256068,97.8,2005
Wolf Creek,30762648,16188180,52.6,14574468,47.4,2005
Two for the Money,30526509,22991379,75.3,7535130,24.7,2005
Cursed,29621722,19297522,65.1,10324200,34.9,2005
The Upside of Anger,28237488,18761993,66.4,9475495,33.6,2005
Mrs. Henderson Presents,27876417,11036366,39.6,16840051,60.4,2005
Ice Princess,27645491,24402491,88.3,3243000,11.7,2005
Goal! The Dream Begins,27610873,4283255,15.5,23327618,84.5,2005
The Protector,27165581,12044087,44.3,15121494,55.7,2005
Doogal,26711924,7438000,27.8,19273924,72.2,2005
Typhoon,26179656,139059,0.5,26040597,99.5,2005
9th Company,26146165,0,0.0,26146165,100.0,2005
Natale a Miami,25643184,0,0.0,25643184,100.0,2005
The Tiger and the Snow,25460023,10167,0.1,25449856,100.0,2005
North Country,25211175,18337722,72.7,6873453,27.3,2005
April Snow,24873159,0,0.0,24873159,100.0,2005
I Love You in Every Language in the World,23941317,0,0.0,23941317,100.0,2005
Lady Vengeance,23834149,211667,0.9,23622482,99.1,2005
Russian Dolls,23727301,326095,1.4,23401206,98.6,2005
Hustle & Flow,23563727,22202809,94.2,1360918,5.8,2005
Another Public Enemy,23248003,0,0.0,23248003,100.0,2005
Domino,22944502,10169202,44.3,12775300,55.7,2005
The White Massai,22632255,0,0.0,22632255,100.0,2005
Manual of Love,22079820,0,0.0,22079820,100.0,2005
Torrente 3: El protector,21762391,0,0.0,21762391,100.0,2005
Man of the House,21577624,19699706,91.3,1877918,8.7,2005
Year One in the North,21360942,0,0.0,21360942,100.0,2005
The Jacket,21126225,6303762,29.8,14822463,70.2,2005
The Devil's Rejects,20901859,17044981,81.5,3856878,18.5,2005
A Moment to Remember,20865847,0,0.0,20865847,100.0,2005
Lorelei,19806585,0,0.0,19806585,100.0,2005
The Perfect Man,19770475,16535005,83.6,3235470,16.4,2005
Mapado,19286223,0,0.0,19286223,100.0,2005
The Weather Man,19126398,12482775,65.3,6643623,34.7,2005
Iznogoud0 Caliph Instead of the Caliph,18725588,0,0.0,18725588,100.0,2005
Detective Conan: Strategy Above the Depths,18723952,0,0.0,18723952,100.0,2005
Waiting...,18637690,16124543,86.5,2513147,13.5,2005
An Unfinished Life,18618284,8586392,46.1,10031892,53.9,2005
My Father and My Son,18612999,0,0.0,18612999,100.0,2005
Keeping Mum,18575768,1619466,8.7,16956302,91.3,2005
The Turkish Gambit,18520000,0,0.0,18520000,100.0,2005
As It Is in Heaven,18318233,0,0.0,18318233,100.0,2005
The World's Fastest Indian,18297690,5128124,28.0,13169566,72.0,2005
Night Watch 2005 Re0release,17939389,1502188,8.4,16437201,91.6,2005
Joyeux Noel,17709155,1054361,6.0,16654794,94.0,2005
You Are My Sunshine,17650142,0,0.0,17650142,100.0,2005
Palais royal!,17612135,0,0.0,17612135,100.0,2005
Roll Bounce,17500866,17380866,99.3,120000,0.7,2005
Rebound,17492014,16809014,96.1,683000,3.9,2005
Stormy Night,17379776,0,0.0,17379776,100.0,2005
The Matador,17347231,12594698,72.6,4752533,27.4,2005
Aegis,16869261,0,0.0,16869261,100.0,2005
Cach√©,16197824,3647381,22.5,12550443,77.5,2005
The Great Yokai War,15787492,0,0.0,15787492,100.0,2005
Kiss Kiss Bang Bang,15785148,4243756,26.9,11541392,73.1,2005
The Gospel,15778152,15778152,100.0,0,0.0,2005
Two Sons of Francisco,15508288,0,0.0,15508288,100.0,2005
The Greatest Game Ever Played,15431177,15337393,99.4,93784,0.6,2005
Transamerica,15151744,9015303,59.5,6136441,40.5,2005
Murder Take One,14915208,0,0.0,14915208,100.0,2005
Most Beautiful Week in My Life,14765033,0,0.0,14765033,100.0,2005
Samurai Commando: Mission 1549,14648713,0,0.0,14648713,100.0,2005
Blood Rain,14270938,0,0.0,14270938,100.0,2005
Proof,14189860,7535331,53.1,6654529,46.9,2005
Pirates of the Caribbean: Dead Man's Chest,1066179725,423315812,39.7,642863913,60.3,2006
The Da Vinci Code,760006945,217536138,28.6,542470807,71.4,2006
Ice Age: The Meltdown,660998756,195330621,29.6,465668135,70.4,2006
Casino Royale,606000064,167445960,27.6,438553632,72.4,2006
Night at the Museum,574480841,250863268,43.7,323617573,56.3,2006
Cars,461983149,244082982,52.8,217900167,47.2,2006
X0Men: The Last Stand,460435291,234362462,50.9,226072829,49.1,2006
Mission: Impossible III,398479497,134029801,33.6,264449696,66.4,2006
Superman Returns,391081192,200081192,51.2,191000000,48.8,2006
Happy Feet,384335608,198000317,51.5,186335291,48.5,2006
Over the Hedge,339795890,155019340,45.6,184776550,54.4,2006
The Devil Wears Prada,326711975,124740460,38.2,201965442,61.8,2006
The Pursuit of Happyness,307127625,163566459,53.3,143561166,46.7,2006
The Departed,291465034,132384315,45.4,159080719,54.6,2006
Borat,262552893,128505958,48.9,134046935,51.1,2006
Eragon,250425512,75030163,30.0,175395349,70.0,2006
Click,240685326,137355633,57.1,103329693,42.9,2006
The Holiday,205844805,63224849,30.7,142617036,69.3,2006
The Break0Up,205668210,118703275,57.7,86964935,42.3,2006
Open Season,200811689,85105259,42.4,115706430,57.6,2006
Inside Man,186003591,88513495,47.6,97490096,52.4,2006
Poseidon,181674817,60674817,33.4,121000000,66.6,2006
Deja Vu,180557550,64038616,35.5,116518934,64.5,2006
Flushed Away,178281554,64665672,36.3,113615882,63.7,2006
Scary Movie 4,178262620,90710620,50.9,87552000,49.1,2006
Blood Diamond,171720398,57377916,33.4,114342482,66.6,2006
Saw III,164874275,80238724,48.7,84635551,51.3,2006
The Pink Panther,164115897,82226474,50.1,81889423,49.9,2006
Miami Vice,163794509,63450470,38.7,100344039,61.3,2006
Talladega Nights: The Ballad of Ricky Bobby,163362095,148213377,90.7,15148718,9.3,2006
World Trade Center,163247198,70278893,43.1,92968305,56.9,2006
The Fast and the Furious: Tokyo Drift,158964610,62514415,39.3,96450195,60.7,2006
Rocky Balboa,155929020,70270943,45.1,85658077,54.9,2006
Dreamgirls,155430335,103365956,66.5,52064379,33.5,2006
Charlotte's Web,148964090,82985708,55.7,65978114,44.3,2006
Garfield: A Tail of Two Kitties,143325970,28426747,19.8,114899223,80.2,2006
Monster House,141861243,73661010,51.9,68200233,48.1,2006
Big Momma's House 2,141522961,70165972,49.6,71356989,50.4,2006
Babel,135330182,34302837,25.3,101027345,74.7,2006
Perfume: The Story of a Murderer,135039924,2223293,1.6,132816631,98.4,2006
V for Vendetta,132511035,70511035,53.2,62000000,46.8,2006
You Me and Dupree,130628903,75628110,57.9,55000793,42.1,2006
Failure to Launch,130224158,88715192,68.1,41508966,31.9,2006
The Queen,123384128,56441711,45.7,66942417,54.3,2006
Apocalypto,120654337,50866635,42.2,69787702,57.8,2006
Eight Below,120455994,81612565,67.8,38843429,32.2,2006
The Omen,119974972,54607383,45.5,65367589,54.5,2006
Final Destination 3,118890272,54098051,45.5,64792221,54.5,2006
Barnyard,116755080,72637803,62.2,44117277,37.8,2006
The Lake House,114830111,52330111,45.6,62500000,54.4,2006
Step Up,114194847,65328121,57.2,48866726,42.8,2006
Underworld: Evolution,111476513,62318875,55.9,49157638,44.1,2006
The Santa Clause 3: The Escape Clause,110768122,84500122,76.3,26268000,23.7,2006
The Prestige,109676311,53089891,48.4,56586420,51.6,2006
Arthur and the Invisibles,107944236,15132763,14.0,92811473,86.0,2006
Little Man,104003322,58645052,56.4,45358270,43.6,2006
The Wild,102338515,37384046,36.5,64954469,63.5,2006
Little Miss Sunshine,101058954,59891098,59.3,41167856,40.7,2006
Silent Hill,100605135,46982632,46.7,53622503,53.3,2006
The Good Shepherd,100266865,59952835,59.8,40314030,40.2,2006
Nacho Libre,99255460,80197993,80.8,19057467,19.2,2006
Deep Sea,98230905,46412757,47.2,51818148,52.8,2006
The Guardian,94973540,55011732,57.9,39961808,42.1,2006
The Host,89431890,2201923,2.5,87229967,97.5,2006
The Illusionist,87892388,39868642,45.4,48023746,54.6,2006
RV,87528173,71726025,81.9,15802148,18.1,2006
The Shaggy Dog,87134280,61123569,70.1,26010711,29.9,2006
Date Movie,85749034,48548426,56.6,37200608,43.4,2006
Volver,85585177,12899867,15.1,72685310,84.9,2006
Jackass Number Two,84645164,72778712,86.0,11866452,14.0,2006
French Fried Vacation 3: Friends Forever,84152064,0,0.0,84152064,100.0,2006
Pan's Labyrinth,83850267,37634615,44.9,46215652,55.1,2006
Firewall,82751189,48751189,58.9,34000000,41.1,2006
Hostel,81979826,47326473,57.7,34653353,42.3,2006
The Sentinel,78810595,36280697,46.0,42529898,54.0,2006
Curse of the Golden Flower,78568977,6566773,8.4,72002204,91.6,2006
The Lives of Others,77356942,11286112,14.6,66070830,85.4,2006
United 93,76700659,31483450,41.0,45217209,59.0,2006
Lady in the Water,72785169,42285169,58.1,30500000,41.9,2006
The Grudge 2,70711175,39143839,55.4,31567336,44.6,2006
Children of Men,70455770,35552383,50.5,34903387,49.5,2006
The Hills Have Eyes,70008952,41778863,59.7,28230089,40.3,2006
Curious George,69865924,58360760,83.5,11505164,16.5,2006
John Tucker Must Die,68844775,41011711,59.6,27833064,40.4,2006
Letters from Iwo Jima,68673228,13756082,20.0,54917146,80.0,2006
Tales from Earthsea,68625104,0,0.0,68625104,100.0,2006
Fearless,68072848,24633730,36.2,43439118,63.8,2006
When a Stranger Calls,67062123,47860214,71.4,19201909,28.6,2006
Take the Lead,66499627,34742066,52.2,31757561,47.8,2006
Flags of Our Fathers,65900249,33602376,51.0,32297873,49.0,2006
16 Blocks,65664721,36895141,56.2,28769580,43.8,2006
The Benchwarmers,64962629,59843754,92.1,5118875,7.9,2006
Madea's Family Reunion,63368939,63318000,99.9,50939,0.1,2006
Snakes on a Plane,62022014,34020814,54.9,28001200,45.1,2006
My Super Ex0Girlfriend,61108981,22530295,36.9,38578686,63.1,2006
Marie Antoinette,60917189,15962471,26.2,44954718,73.8,2006
Limit of Love: Umizaru,60369589,0,0.0,60369589,100.0,2006
Invincible,58480828,57806952,98.8,673876,1.2,2006
She's the Man,57194667,33741133,59.0,23453534,41.0,2006
Lucky Number Slevin,56308881,22495466,40.0,33813415,60.0,2006
The Ant Bully,55181129,28142535,51.0,27038594,49.0,2006
Stranger Than Fiction,53653224,40660952,75.8,12992272,24.2,2006
The Texas Chainsaw Massacre: The Beginning,51764406,39517763,76.3,12246643,23.7,2006
Doomsday: The Sinking of Japan,51127401,0,0.0,51127401,100.0,2006
Notes on a Scandal,49814392,17510118,35.2,32304274,64.8,2006
An Inconvenient Truth,49782012,24146161,48.5,25635851,51.5,2006
The Black Dahlia,49332692,22545080,45.7,26787612,54.3,2006
The Last King of Scotland,48618191,17606684,36.2,31011507,63.8,2006
Suite Dreams,48090431,0,0.0,48090431,100.0,2006
Death Note: The Last Name,47917637,0,0.0,47917637,100.0,2006
Deck the Halls,47232776,35093569,74.3,12139207,25.7,2006
The Nativity Story,46432264,37629831,81.0,8802433,19.0,2006
We Are Marshall,43545364,43545364,100.0,0,0.0,2006
Last Holiday,43451846,38399961,88.4,5051885,11.6,2006
Glory Road,42938449,42647449,99.3,291000,0.7,2006
Crank,42931041,27838408,64.8,15092633,35.2,2006
Man of the Year,42472472,37327390,87.9,5145082,12.1,2006
A Good Year,42269923,7459300,17.6,34810623,82.4,2006
200 Pounds Beauty,42013016,0,0.0,42013016,100.0,2006
Gridiron Gang,41480851,38432823,92.7,3048028,7.3,2006
Thank You for Smoking,39323027,24793509,63.1,14529518,36.9,2006
Scoop,39220946,10525717,26.8,28695229,73.2,2006
Tazza: The High Rollers,39212715,0,0.0,39212715,100.0,2006
The Wicker Man,38805380,23649127,60.9,15156253,39.1,2006
Basic Instinct 2,38629478,5971336,15.5,32658142,84.5,2006
Accepted,38623262,36323505,94.0,2299757,6.0,2006
Employee of the Month,38528984,28444855,73.8,10084129,26.2,2006
Day Watch,38411815,0,0.0,38411815,100.0,2006
Just My Luck,38159905,17326650,45.4,20833255,54.6,2006
Camping,37912041,0,0.0,37912041,100.0,2006
The Covenant,37598767,23380495,62.2,14218272,37.8,2006
Miss Potter,35078241,3005605,8.6,32072636,91.4,2006
Bambi II,34958637,0,0.0,34958637,100.0,2006
Love and Honor,33755574,60910,0.2,33694664,99.8,2006
Tell No One,33406992,6177192,18.5,27229800,81.5,2006
7 Dwarves: The Forest Is Not Enough,32863752,0,0.0,32863752,100.0,2006
Dhoom 2,32396427,2643586,8.2,29752841,91.8,2006
Stick It,31976848,26910736,84.2,5066112,15.8,2006
Deutschland. Ein Sommerm√§rchen,31257991,0,0.0,31257991,100.0,2006
Ultraviolet,31070211,18535812,59.7,12534399,40.3,2006
Doraemon the Movie: Nobita's Dinosaur,30963292,0,0.0,30963292,100.0,2006
Twosabu ilchae,30622421,0,0.0,30622421,100.0,2006
Natale a New York,30437121,0,0.0,30437121,100.0,2006
I Do: How to Get Married and Stay Single,30057369,0,0.0,30057369,100.0,2006
Pulse,29907685,20264436,67.8,9643249,32.2,2006
Death Note,29630359,0,0.0,29630359,100.0,2006
An American Haunting,29612137,16298046,55.0,13314091,45.0,2006
The Valet,29414553,1926800,6.6,27487753,93.4,2006
Tristan + Isolde,28047963,14734633,52.5,13313330,47.5,2006
Priceless,27949650,2165188,7.7,25784462,92.3,2006
Pok√©mon Ranger and the Temple of the Sea,27638625,0,0.0,27638625,100.0,2006
Stay Alive,27298695,23086480,84.6,4212215,15.4,2006
Clerks II,26984975,24148068,89.5,2836907,10.5,2006
The Painted Veil,26910847,8060487,30.0,18850360,70.0,2006
Black Book,26768563,4398532,16.4,22370031,83.6,2006
Detective Conan: The Private Eyes' Requiem,26251232,0,0.0,26251232,100.0,2006
A Prairie Home Companion,25978867,20342852,78.3,5636015,21.7,2006
You Are So Beautiful,25329576,0,0.0,25329576,100.0,2006
Tears for You,25300338,0,0.0,25300338,100.0,2006
Kabhi Alvida Naa Kehna,25229168,3275444,13.0,21953724,87.0,2006
School for Scoundrels,23947685,17807569,74.4,6140116,25.6,2006
Stormbreaker,23937870,677646,2.8,23260224,97.2,2006
Il mio miglior nemico,23710143,0,0.0,23710143,100.0,2006
Valley of the Wolves: Iraq,23465471,0,0.0,23465471,100.0,2006
Captain Alatriste: The Spanish Musketeer,23321954,0,0.0,23321954,100.0,2006
OSS 117: Cairo Nest of Spies,23055884,303543,1.3,22752341,98.7,2006
Aquamarine,22989957,18597342,80.9,4392615,19.1,2006
Days of Glory,22963701,320700,1.4,22643001,98.6,2006
The Wind that Shakes the Barley,22899908,1836089,8.0,21063819,92.0,2006
The Banquet,22598772,0,0.0,22598772,100.0,2006
Asterix and the Vikings,22501596,0,0.0,22501596,100.0,2006
Fanaa,22175908,2105352,9.5,20070556,90.5,2006
The Marine,22165608,18844784,85.0,3320824,15.0,2006
Unaccompanied Minors,21949234,16655224,75.9,5294010,24.1,2006
Flicka,21893591,21000147,95.9,893444,4.1,2006
Rob0B0Hood,21836580,0,0.0,21836580,100.0,2006
Wolfhound,21573338,0,0.0,21573338,100.0,2006
Black Christmas,21510851,16273581,75.7,5237270,24.3,2006
Waist Deep,21353303,21344312,100.0,8991,0.1,2006
ATL,21170563,21170563,100.0,0,0.0,2006
Bobby,20704591,11242801,54.3,9461790,45.7,2006
Beerfest,20387597,19185184,94.1,1202413,5.9,2006
Don,19640129,2223961,11.3,17416168,88.7,2006
Movie: Marrying the Mafia 3 0 Family Hustle,19606487,0,0.0,19606487,100.0,2006
Akeelah and the Bee,18948425,18848430,99.5,99995,0.5,2006
See No Evil,18564467,15032800,81.0,3531667,19.0,2006
Hanbando,18483140,0,0.0,18483140,100.0,2006
Bandidas,18381890,0,0.0,18381890,100.0,2006
Friends with Money,18245244,13368437,73.3,4876807,26.7,2006
Krrish,18041250,1430721,7.9,16610529,92.1,2006
Lage Raho Munna Bhai,17897527,2217562,12.4,15679965,87.6,2006
Flyboys,17834865,13090630,73.4,4744235,26.6,2006
Battle of the Warriors,17812601,0,0.0,17812601,100.0,2006
Memories of Tomorrow,17696020,140200,0.8,17555820,99.2,2006
Grave Decisions,17685834,0,0.0,17685834,100.0,2006
Orchestra Seats,17574836,2044858,11.6,15529978,88.4,2006
Annapolis,17496992,17127992,97.9,369000,2.1,2006
Paris I Love You,17471727,4899278,28.0,12572449,72.0,2006
Material Girls,16907725,11449638,67.7,5458087,32.3,2006
Zhara,16877870,0,0.0,16877870,100.0,2006
Pirates of the Caribbean: At World's End,960996492,309420425,32.2,651576067,67.8,2007
Harry Potter and the Order of the Phoenix,941934579,292004738,31.0,649928484,69.0,2007
Spider0Man 3,894983373,336530303,37.6,558453070,62.4,2007
Shrek the Third,813367380,322719944,39.7,490647436,60.3,2007
Transformers,709709780,319246193,45.0,390463587,55.0,2007
Ratatouille,623726085,206445654,33.1,417280431,66.9,2007
I Am Legend,585410052,256393010,43.8,329017042,56.2,2007
The Simpsons Movie,536414270,183135014,34.1,353279256,65.9,2007
National Treasure: Book of Secrets,459242249,219964115,47.9,239278134,52.1,2007
300,456068181,210614939,46.2,245453242,53.8,2007
The Bourne Ultimatum,444100035,227471070,51.2,216628965,48.8,2007
Live Free or Die Hard,388156011,134529403,34.7,253626608,65.3,2007
The Golden Compass,372234864,70107728,18.8,302127136,81.2,2007
Alvin and the Chipmunks,365352546,217326974,59.5,148025572,40.5,2007
Enchanted,340487652,127807262,37.5,212680390,62.5,2007
Ocean's Thirteen,311312624,117154724,37.6,194157900,62.4,2007
Fantastic Four: Rise of the Silver Surfer,301913131,131921738,43.7,169991393,56.3,2007
Bee Movie,293514336,126631277,43.1,166883059,56.9,2007
American Gangster,269755430,130164645,48.3,139590785,51.7,2007
Rush Hour 3,258097122,140125968,54.3,117971154,45.7,2007
Wild Hogs,253625427,168273550,66.3,85351877,33.7,2007
Juno,232372681,143495265,61.8,88877416,38.2,2007
Mr. Bean's Holiday,232225908,33302167,14.3,198923741,85.7,2007
Ghost Rider,228738393,115802596,50.6,112935797,49.4,2007
Knocked Up,219922417,148768917,67.6,71153500,32.4,2007
Hairspray,203553768,118871849,58.4,84681073,41.6,2007
Beowulf,196393745,82280579,41.9,114113166,58.1,2007
I Now Pronounce You Chuck & Larry,187134117,120059556,64.2,67074561,35.8,2007
Knowing,183658498,79957634,43.5,103700864,56.5,2007
The Bucket List,175372502,93466502,53.3,81906000,46.7,2007
Evan Almighty,174440724,100462298,57.6,73978426,42.4,2007
No Country for Old Men,171627166,74283625,43.3,97343541,56.7,2007
Superbad,170812574,121463226,71.1,49349300,28.9,2007
Meet the Robinsons,169333034,97822171,57.8,71510863,42.2,2007
Norbit,159814490,95673607,59.9,64140883,40.1,2007
P.S. I Love You,156835339,53695808,34.2,103139531,65.8,2007
Sweeney Todd: The Demon Barber of Fleet Street,153383627,52898073,34.5,100485554,65.5,2007
Surf's Up,152005713,58867694,38.7,93138019,61.3,2007
The Game Plan,147880543,90648202,61.3,57232341,38.7,2007
Resident Evil: Extinction,147717833,50648679,34.3,97069154,65.7,2007
Music and Lyrics,145896422,50572589,34.7,95323833,65.3,2007
Blades of Glory,145710347,118594548,81.4,27115799,18.6,2007
Saw IV,139352633,63300095,45.4,76052538,54.6,2007
Bridge to Terabithia,137587063,82272442,59.8,55314621,40.2,2007
Stardust,137515140,38634938,28.1,98880202,71.9,2007
1408,132963417,71985628,54.1,60977789,45.9,2007
Aliens vs. Predator: Requiem,130290885,41797066,32.1,88493819,67.9,2007
Atonement,129266061,50927067,39.4,78338994,60.6,2007
The Heartbreak Kid,128453183,36787257,28.6,91665926,71.4,2007
Charlie Wilson's War,119483446,66661095,55.8,52822351,44.2,2007
Disturbia,118114220,80209692,67.9,37904528,32.1,2007
Earth,108975160,32011576,29.4,76963584,70.6,2007
The Water Horse,103967384,40946255,39.4,63021129,60.6,2007
Hitman,101276318,39687694,39.2,61588624,60.8,2007
Fred Claus,97838349,72006777,73.6,25831572,26.4,2007
TMNT,95797812,54149098,56.5,41648714,43.5,2007
Shooter,95696996,47003582,49.1,48693414,50.9,2007
Michael Clayton,92991835,49033882,52.7,43957953,47.3,2007
No Reservations,92601050,43107979,46.6,49493071,53.4,2007
Fracture,92011561,39015018,42.4,52996543,57.6,2007
Epic Movie,87238158,39739367,45.6,47498791,54.4,2007
The Kingdom,87019158,47536778,54.6,39482380,45.4,2007
La Vie En Rose,86274793,10301706,11.9,75973087,88.1,2007
Zodiac,84785914,33080084,39.0,51705830,61.0,2007
Premonition,84146832,47852604,56.9,36294228,43.1,2007
Hannibal Rising,82169884,27670986,33.7,54498898,66.3,2007
Rabbit Without Ears,81744033,0,0.0,81744033,100.0,2007
Hot Fuzz,80577265,23637265,29.3,56940000,70.7,2007
Halloween,80460948,58272029,72.4,22188919,27.6,2007
The Orphanage,78638987,7161284,9.1,71477703,90.9,2007
The Number 23,77677553,35193167,45.3,42484386,54.7,2007
Next,77621983,18211013,23.5,59410970,76.5,2007
There Will Be Blood,76181545,40222514,52.8,35959031,47.2,2007
Elizabeth: The Golden Age,75782758,16383509,21.6,59399249,78.4,2007
30 Days of Night,75513170,39569000,52.4,35944170,47.6,2007
Stomp the Yard,75511123,61356221,81.3,14154902,18.7,2007
Dragon Wars: D0War,75108817,10977721,14.6,64131096,85.4,2007
The Kite Runner,75011029,15800078,21.1,59210951,78.9,2007
Perfect Stranger,73534117,23984949,32.6,49549168,67.4,2007
License to Wed,70181325,43799818,62.4,26381507,37.6,2007
3:10 to Yuma,70016220,53606916,76.6,16409304,23.4,2007
The Brave One,69787394,36793804,52.7,32993590,47.3,2007
Because I Said So,69485490,42674040,61.4,26811450,38.6,2007
Mr. Magorium's Wonder Emporium,69474661,32061555,46.1,37413106,53.9,2007
Dan in Real Life,68471669,47642963,69.6,20828706,30.4,2007
Lust Caution,67091915,4604982,6.9,62486933,93.1,2007
August Rush,66122026,31664162,47.9,34457864,52.1,2007
Underdog,65270477,43760605,67.0,21509872,33.0,2007
Taxi 4,65125001,0,0.0,65125001,100.0,2007
28 Weeks Later,65048678,28638916,44.0,36409762,56.0,2007
Lions for Lambs,64811540,15002854,23.1,49808686,76.9,2007
The Reaping,62771059,25126214,40.0,37644845,60.0,2007
Good Luck Chuck,59768495,35017297,58.6,24751198,41.4,2007
Are We Done Yet?,58388068,49662533,85.1,8725535,14.9,2007
The Mist,57470220,25594957,44.5,31875263,55.5,2007
Smokin' Aces,57232879,35787686,62.5,21445193,37.5,2007
Into the Wild,56674477,18354356,32.4,38320121,67.6,2007
Eastern Promises,56106607,17266000,30.8,38840607,69.2,2007
Why Did I Get Married?,55862886,55204525,98.8,658361,1.2,2007
The Irony of Fate 2,55639741,0,0.0,55639741,100.0,2007
We Own the Night,55033767,28563179,51.9,26470588,48.1,2007
The Messengers,55010659,35374833,64.3,19635826,35.7,2007
Sea Monsters: A Prehistoric Adventure,50652463,23746066,46.9,26906397,53.1,2007
This Christmas,49778552,49121934,98.7,656618,1.3,2007
###############################################################################################################################################################################################################################################################,49282156,0,0.0,49282156,100.0,2007
Mr. Brooks,48443734,28549298,58.9,19894436,41.1,2007
The Nanny Diaries,47817020,25930652,54.2,21886368,45.8,2007
Death at a Funeral,46789413,8580428,18.3,38208985,81.7,2007
Freedom Writers,43095175,36605602,84.9,6489573,15.1,2007
The Warlords,42883181,129078,0.3,42754103,99.7,2007
Pok√©mon: The Rise of Darkrai,42496749,0,0.0,42496749,100.0,2007
Always: Sunset on Third Street 2,42304705,0,0.0,42304705,100.0,2007
Balls of Fury,41739111,32886940,78.8,8852171,21.2,2007
Breach,40953935,33231264,81.1,7722671,18.9,2007
War,40481352,22486409,55.5,17994943,44.5,2007
The Invasion,40170558,15074191,37.5,25096367,62.5,2007
Om Shanti Om,39990809,3597372,9.0,36393437,91.0,2007
Happily N'Ever After,38085778,15589393,40.9,22496385,59.1,2007
The Hills Have Eyes 2,37697773,20804166,55.2,16893607,44.8,2007
Natale in crociera,37350000,0,0.0,37350000,100.0,2007
Becoming Jane,37311672,18670946,50.0,18640726,50.0,2007
Monkey Magic,36745063,0,0.0,36745063,100.0,2007
Sky of Love,36684020,0,0.0,36684020,100.0,2007
Sicko,36093504,24540079,68.0,11553425,32.0,2007
Hostel: Part II,35728183,17609452,49.3,18118731,50.7,2007
Vacancy,35442935,19363565,54.6,16079370,45.4,2007
The Darjeeling Limited,35078918,11902715,33.9,23176203,66.1,2007
Sunshine,34806360,3675753,10.6,31130607,89.4,2007
Assembly,34786960,0,0.0,34786960,100.0,2007
Gone Baby Gone,34612443,20292962,58.6,14319481,41.4,2007
Mr. Woodcock,33683200,25799486,76.6,7883714,23.4,2007
Run Fatboy Run,33478921,6003262,17.9,27475659,82.1,2007
Doraemon the Movie: Nobita's New Great Adventure into the Underworld,32787846,0,0.0,32787846,100.0,2007
Awake,32730062,14377198,43.9,18352864,56.1,2007
88 Minutes,32593385,17213467,52.8,15379918,47.2,2007
REC,32511655,0,0.0,32511655,100.0,2007
Alpha Dog,32351125,15309602,47.3,17041523,52.7,2007
Amazing Grace,32120360,21250683,66.2,10869677,33.8,2007
Hunting and Gathering,31920899,0,0.0,31920899,100.0,2007
The Seeker: The Dark Is Rising,31852619,8794452,27.6,23058167,72.4,2007
Daddy's Little Girls,31609243,31366978,99.2,242265,0.8,2007
Love in the Time of Cholera,31575877,4607608,14.6,26968269,85.4,2007
Welcome,31203567,0,0.0,31203567,100.0,2007
Pathfinder,30984583,10232081,33.0,20752502,67.0,2007
Nancy Drew,30666930,25612520,83.5,5054410,16.5,2007
Death Proof,30663961,0,0.0,30663961,100.0,2007
A Beautiful Wife,30385222,0,0.0,30385222,100.0,2007
The Great Debaters,30236407,30236407,100.0,0,0.0,2007
A Tale of Mari and Three Puppies,30183621,0,0.0,30183621,100.0,2007
Lissi und der wilde Kaiser,29733764,0,0.0,29733764,100.0,2007
The Fox and the Child,29610210,0,0.0,29610210,100.0,2007
In the Valley of Elah,29541790,6777741,22.9,22764049,77.1,2007
Across the Universe,29367143,24343673,82.9,5023470,17.1,2007
St. Trinian's,29067829,0,0.0,29066483,100.0,2007
Manual of Love 2,27833482,0,0.0,27833482,100.0,2007
The Last Mimzy,27308918,21471047,78.6,5837871,21.4,2007
Dororo,27308865,0,0.0,27308865,100.0,2007
Shoot 'Em Up,27122238,12807139,47.2,14315099,52.8,2007
Rendition,27066382,9736045,36.0,17330337,64.0,2007
The Invisible,26810113,20578909,76.8,6231204,23.2,2007
Mongol: The Rise of Genghis Khan,26527510,5705761,21.5,20821749,78.5,2007
Bratz,26013153,10010209,38.5,16002944,61.5,2007
Grindhouse,25422088,25037897,98.5,384191,1.5,2007
The Hitcher,25399945,16472961,64.9,8926984,35.1,2007
The Last Legion,25303038,5933494,23.4,19369544,76.6,2007
Before the Devil Knows You're Dead,25037657,7084227,28.3,17953430,71.7,2007
Georgia Rule,25000167,19103072,76.4,5897095,23.6,2007
Guru,24108727,2096000,8.7,22012727,91.3,2007
Partner,23968620,1062840,4.4,22905780,95.6,2007
Persepolis,22783978,4445756,19.5,18338222,80.5,2007
Cassandra's Dream,22686378,973018,4.3,21713360,95.7,2007
Dead Silence,22382047,16809076,75.1,5572971,24.9,2007
Reign Over Me,22242388,19661987,88.4,2580401,11.6,2007
Waitress,22240529,19074800,85.8,3165729,14.2,2007
Crows Zero,22036607,0,0.0,22036607,100.0,2007
Reno 911!: Miami,22021262,20342161,92.4,1679101,7.6,2007
My Blueberry Nights,22007671,867275,3.9,21140396,96.1,2007
Unfair: The Movie,21914005,0,0.0,21914005,100.0,2007
Like Stars on Earth,21897373,1223869,5.6,20673504,94.4,2007
Chak De! India,21505244,1120404,5.2,20384840,94.8,2007
Arn: The Knight Templar,21287566,0,0.0,21287566,100.0,2007
Penelope,21156270,10011996,47.3,11144274,52.7,2007
Once,20936722,9439923,45.1,11496799,54.9,2007
Le Grand Chef,20794760,0,0.0,20794760,100.0,2007
Walk Hard: The Dewey Cox Story,20577458,18317151,89.0,2259047,11.0,2007
Detective Conan: Jolly Roger in the Deep Azure,20440213,0,0.0,20440213,100.0,2007
The Namesake,20354321,13569248,66.7,6785073,33.3,2007
Evening,20016753,12492481,62.4,7524272,37.6,2007
The Diving Bell and the Butterfly,19780116,6003227,30.3,13776889,69.7,2007
Two Days in Paris,19776159,4433994,22.4,15342165,77.6,2007
Bhool Bhulaiyaa,19073095,1097797,5.8,17975298,94.2,2007
A Mighty Heart,19008745,9176787,48.3,9831958,51.7,2007
The Wild Guys 4,18873863,0,0.0,18873863,100.0,2007
Kitaro,18856642,0,0.0,18856642,100.0,2007
The Counterfeiters,18814713,5488570,29.2,13326143,70.8,2007
Ho voglia di te,18594142,0,0.0,18594142,100.0,2007
Saawariya,18513120,885574,4.8,17627546,95.2,2007
Daddy Day Camp,18197398,13235267,72.7,4962131,27.3,2007
Voice of a Murderer,18160598,0,0.0,18160598,100.0,2007
The Dark Knight,1003845358,533345358,53.1,470500000,46.9,2008
Indiana Jones and the Kingdom of the Crystal Skull,786636033,317101119,40.3,469534914,59.7,2008
Kung Fu Panda,631744560,215434591,34.1,416309969,65.9,2008
Hancock,629443428,227946274,36.2,401497154,63.8,2008
Mamma Mia!,610002542,144290968,23.7,465711574,76.3,2008
Madagascar: Escape 2 Africa,603900354,180010950,29.8,423889404,70.2,2008
Quantum of Solace,589580694,168368427,28.6,421212055,71.4,2008
Iron Man,585366247,318604126,54.4,266762121,45.6,2008
WALL¬∑E,521311860,223808164,42.9,297503696,57.1,2008
The Chronicles of Narnia: Prince Caspian,419665568,141621490,33.7,278044078,66.3,2008
Sex and the City,418765321,152647258,36.5,266118063,63.5,2008
Twilight,407230267,192769854,47.3,214417861,52.7,2008
The Mummy: Tomb of the Dragon Emperor,403449830,102491776,25.4,300958054,74.6,2008
Slumdog Millionaire,378410113,141319928,37.3,237090185,62.7,2008
Wanted,342463063,134508551,39.3,207954512,60.7,2008
The Curious Case of Benjamin Button,335802786,127509326,38.0,208293460,62.0,2008
Bolt,309979994,114053579,36.8,195926415,63.2,2008
Horton Hears a Who!,298572799,154529439,51.8,144043360,48.2,2008
Gran Torino,269958228,148095302,54.9,121862926,45.1,2008
10000 BC,269784201,94784201,35.1,175000000,64.9,2008
The Incredible Hulk,264770996,134806913,50.9,129964083,49.1,2008
Marley & Me,255743093,143153751,56.0,112589342,44.0,2008
High School Musical 3: Senior Year,252909177,90559416,35.8,162349761,64.2,2008
Welcome to the Sticks,245144417,0,0.0,245144417,100.0,2008
Journey to the Center of the Earth,244232688,101704370,41.6,142528318,58.4,2008
The Day the Earth Stood Still,233093859,79366978,34.0,153726881,66.0,2008
Get Smart,230685453,130319208,56.5,100366245,43.5,2008
Taken,226837760,145000989,63.9,81836771,36.1,2008
Jumper,225132113,80172128,35.6,144959985,64.4,2008
Yes Man,223241637,97690976,43.8,125550661,56.2,2008
What Happens in Vegas,219375562,80277646,36.6,139097916,63.4,2008
Bedtime Stories,212874864,110101975,51.7,102772889,48.3,2008
Australia,211788739,49554002,23.4,162233509,76.6,2008
You Don't Mess with the Zohan,204313400,100018837,49.0,104294563,51.0,2008
Ponyo,204171845,15090399,7.4,189081411,92.6,2008
Valkyrie,201545517,83077833,41.2,118467684,58.8,2008
Tropic Thunder,195703047,110515313,56.5,85187498,43.5,2008
Eagle Eye,178767383,101440743,56.7,77326640,43.3,2008
Cloverfield,172394180,80048433,46.4,92345747,53.6,2008
Seven Pounds,169748929,69951824,41.2,99797105,58.8,2008
Hellboy II: The Golden Army,168319243,75986503,45.1,92332740,54.9,2008
The Spiderwick Chronicles,164170327,71195053,43.4,92975274,56.6,2008
Four Christmases,164112721,120146040,73.2,43966681,26.8,2008
Burn After Reading,163728902,60355347,36.9,103373555,63.1,2008
The Happening,163403799,64506874,39.5,98896925,60.5,2008
27 Dresses,162655351,76808654,47.2,85846697,52.8,2008
21,159808370,81159365,50.8,78649005,49.2,2008
Vantage Point,152039882,72266306,47.5,79773576,52.5,2008
Step Up 2: The Streets,150816700,58017783,38.5,92798917,61.5,2008
Beverly Hills Chihuahua,149292488,94514402,63.3,54778086,36.7,2008
Asterix at the Olympic Games,131856927,0,0.0,131856927,100.0,2008
Red Cliff,129708433,627047,0.5,129081386,99.5,2008
The Forbidden Kingdom,128779982,52075270,40.4,76704712,59.6,2008
Step Brothers,128107642,100468793,78.4,27638849,21.6,2008
Body of Lies,115900897,39394666,34.0,76506231,66.0,2008
Saw V,113864059,56746769,49.8,57117290,50.2,2008
Changeling,113398237,35739802,31.5,77658435,68.5,2008
Rambo,113244290,42754105,37.8,70490185,62.2,2008
Fool's Gold,111231041,70231041,63.1,41000000,36.9,2008
Transporter 3,108979549,31715062,29.1,77264487,70.9,2008
The Reader,108902486,34194407,31.4,74708079,68.6,2008
Made of Honor,106407672,46012734,43.2,60394938,56.8,2008
Forgetting Sarah Marshall,105833257,63172463,59.7,42660794,40.3,2008
Pineapple Express,101624843,87341380,85.9,14283463,14.1,2008
Nim's Island,100104565,48006762,48.0,52097803,52.0,2008
Vicky Cristina Barcelona,96409830,23216709,24.1,73192591,75.9,2008
Speed Racer,93945766,43945766,46.8,50000000,53.2,2008
Role Models,92649419,67294270,72.6,25355149,27.4,2008
Max Payne,87066930,40689393,46.7,46377537,53.3,2008
The Tale of Despereaux,86957280,50877145,58.5,36080135,41.5,2008
Meet the Spartans,85897593,38233676,44.5,47663917,55.5,2008
Nights in Rodanthe,84375346,41850659,49.6,42524687,50.4,2008
The Strangers,82410456,52597610,63.8,29812846,36.2,2008
Righteous Kill,78460699,40081410,51.1,38379289,48.9,2008
The Other Boleyn Girl,78199679,26814957,34.3,51384722,65.7,2008
Mirrors,78094714,30691439,39.3,47403275,60.7,2008
Death Race,76014335,36316032,47.8,39698303,52.2,2008
Revolutionary Road,75981180,22911480,30.2,53069700,69.8,2008
Boys Over Flowers: Final,72243609,0,0.0,72243609,100.0,2008
Babylon A.D.,72109200,22532572,31.2,49576628,68.8,2008
Superhero Movie,71538062,25881068,36.2,45656994,63.8,2008
Hannah Montana and Miley Cyrus: Best of Both Worlds Concert,70642966,65281781,92.4,5361185,7.6,2008
Departures,70442129,1498210,2.1,68943919,97.9,2008
The House Bunny,70439696,48237389,68.5,22202307,31.5,2008
The X Files: I Want to Believe,69363381,20982478,30.3,48380903,69.7,2008
Star Wars: The Clone Wars,68282844,35161554,51.5,33121290,48.5,2008
Street Kings,66476363,26418667,39.7,40057696,60.3,2008
Space Chimps,65097693,30105968,46.2,34991725,53.8,2008
The Bank Job,64822796,30060660,46.4,34762136,53.6,2008
Baby Mama,64444713,60494212,93.9,3950501,6.1,2008
Inkheart,62803180,17303424,27.6,45499756,72.4,2008
Prom Night,57197876,43869350,76.7,13328526,23.3,2008
Definitely Maybe,55990299,32241649,57.6,23748650,42.4,2008
Suspect X,54846110,0,0.0,54846110,100.0,2008
Milk,54589558,31841299,58.3,22748259,41.7,2008
Untraceable,52933513,28687835,54.2,24245678,45.8,2008
Doubt,51699984,33446470,64.7,18253514,35.3,2008
College Road Trip,51549674,45610425,88.5,5939249,11.5,2008
Meet Dave,51339567,11803254,23.0,39536313,77.0,2008
Defiance,51262751,28644813,55.9,22617938,44.1,2008
The Women,50007546,26902075,53.8,23105471,46.2,2008
Drillbit Taylor,49944325,32862104,65.8,17082221,34.2,2008
CJ7,49529913,207378,0.4,49322535,99.6,2008
The Hurt Locker,49230772,17017811,34.6,32212961,65.4,2008
Shutter,48555306,25928550,53.4,22626756,46.6,2008
Pok√©mon: Giratina and the Sky Warrior,47511422,0,0.0,47511422,100.0,2008
If You Are the One,45521453,0,0.0,45521453,100.0,2008
The Wrestler,44734660,26238243,58.7,18496417,41.3,2008
Lakeview Terrace,44655002,39263506,87.9,5391496,12.1,2008
The Sisterhood of the Traveling Pants 2,44352417,44089964,99.4,262453,0.6,2008
The Good the Bad the Weird,44261209,128486,0.3,44132723,99.7,2008
Semi0Pro,44004502,33479698,76.1,10524804,23.9,2008
Welcome Home Roscoe Jenkins,43655418,42436517,97.2,1218901,2.8,2008
Harold & Kumar Escape from Guantanamo Bay,43495888,38108728,87.6,5387160,12.4,2008
The Duchess,43343384,13848978,32.0,29494406,68.0,2008
Zack and Miri Make a Porno,42782463,31457946,73.5,11324517,26.5,2008
Bangkok Dangerous,42487390,15298133,36.0,27189257,64.0,2008
Meet the Browns,41975388,41975388,100.0,0,0.0,2008
Scandal Makers,41745790,0,0.0,41745790,100.0,2008
Fly Me to the Moon 3D,41721414,13816982,33.1,27904432,66.9,2008
Never Back Down,41627431,24850922,59.7,16776509,40.3,2008
My Best Friend's Girl,41624687,19219250,46.2,22405437,53.8,2008
Escape Captivity: The Movie,41550983,0,0.0,41550983,100.0,2008
Quarantine,41319906,31691811,76.7,9628095,23.3,2008
Leatherheads,41319039,31373938,75.9,9945101,24.1,2008
The Love Guru,40877556,32235793,78.9,8641763,21.1,2008
The Boy in the Striped Pajamas,40416563,9046156,22.4,31370407,77.6,2008
The Secret Life of Bees,39952437,37770162,94.5,2182275,5.5,2008
The Spirit,39164441,19806188,50.6,19358253,49.4,2008
Admiral,39143985,0,0.0,39143985,100.0,2008
First Sunday,38810311,37931869,97.7,878442,2.3,2008
Ghajini,38316584,2430627,6.3,35885957,93.7,2008
20th Century Boys 1: Beginning of the End,38231562,0,0.0,38231562,100.0,2008
Painted Skin,37579689,0,0.0,37579689,100.0,2008
The Family That Preys,37105289,37105289,100.0,0,0.0,2008
Natale a Rio,36702844,0,0.0,36702844,100.0,2008
The Chaser,36467587,0,0.0,36467587,100.0,2008
The Magic Hour,36023586,0,0.0,36023586,100.0,2008
Death Note: L Change the World,35319632,0,0.0,35319632,100.0,2008
Gomorrah,34861529,1579146,4.5,33282383,95.5,2008
Disaster Movie,34816824,14190901,40.8,20625923,59.2,2008
Nick and Norah's Infinite Playlist,33556631,31487293,93.8,2069338,6.2,2008
Fireproof,33473297,33456317,99.9,16980,0.1,2008
In Bruges,33394440,7800824,23.4,25593616,76.6,2008
Che: Part One,33266274,0,0.0,33266274,100.0,2008
Last Chance Harvey,32566966,14889042,45.7,17677924,54.3,2008
The Wave,32350637,0,0.0,32350637,100.0,2008
Doraemon the Movie: Nobita and the Green Giant Legend,31684949,0,0.0,31684949,100.0,2008
Pride and Glory,31200557,15740721,50.5,15459836,49.5,2008
Igor,30893885,19528602,63.2,11365283,36.8,2008
Be Kind Rewind,30579406,11175164,36.5,19404242,63.5,2008
The Best Movie,30525503,0,0.0,30525503,100.0,2008
Mesrine: Killer Instinct,30503743,0,0.0,30503743,100.0,2008
Rab Ne Bana Di Jodi,29914469,2078956,6.9,27835513,93.1,2008
W.,29560587,25534493,86.4,4026094,13.6,2008
The Class,29303505,3766810,12.9,25536695,87.1,2008
Singh Is King,29169677,2159376,7.4,27010301,92.6,2008
Recep Ivedik,28548025,0,0.0,28548025,100.0,2008
Appaloosa,27712362,20211394,72.9,7500968,27.1,2008
Traitor,27674464,23530831,85.0,4143633,15.0,2008
Frost/Nixon,27426335,18622031,67.9,8804304,32.1,2008
Forever the Moment,27259300,0,0.0,27259300,100.0,2008
Public Enemy 3,27226420,0,0.0,27226420,100.0,2008
Ghost Town,27090159,13367624,49.3,13722535,50.7,2008
The Baader Meinhof Complex,26937355,476270,1.8,26461085,98.2,2008
Jodhaa Akbar,26890354,3440718,12.8,23449636,87.2,2008
Mad Money,26412163,20668843,78.3,5743320,21.7,2008
RocknRolla,25742207,5700626,22.1,20040237,77.8,2008
I'm a Cat Stalker,25221446,0,0.0,25221446,100.0,2008
Race,24503269,1367024,5.6,23136245,94.4,2008
Detroit Metal City,23744571,0,0.0,23744571,100.0,2008
Disco,23524551,0,0.0,23524551,100.0,2008
Paris,23328518,1010194,4.3,22318324,95.7,2008
Under the Same Moon,23313049,12590147,54.0,10722902,46.0,2008
Sorry If I Love You,23249815,0,0.0,23249815,100.0,2008
Detective Conan: Full Score of Fear,22996756,0,0.0,22996756,100.0,2008
Kung Fu Dunk,22945567,0,0.0,22945567,100.0,2008
The Merry Widow,22872698,0,0.0,22872698,100.0,2008
The Ruins,22818256,17432844,76.4,5385412,23.6,2008
U2 3D,22730842,10363341,45.6,12367501,54.4,2008
The Accidental Husband,22707064,0,0.0,22707064,100.0,2008
Paco and the Magical Book,22679633,0,0.0,22679633,100.0,2008
Doomsday,22472631,11008770,49.0,11463861,51.0,2008
I've Loved You So Long,22272176,3169305,14.2,19102871,85.8,2008
A.R.O.G,22212369,0,0.0,22212369,100.0,2008
Ip Man,22108789,0,0.0,22108789,100.0,2008
Wild Child,21972336,0,0.0,21972336,100.0,2008
Grande grosso e... Verdone,21860130,0,0.0,21860130,100.0,2008
The Flight Before Christmas,21822495,0,0.0,21822495,100.0,2008
Over Her Dead Body,21458111,7563670,35.2,13894441,64.8,2008
K020: The Fiend with Twenty Faces,21443265,0,0.0,21443265,100.0,2008
Three Kingdoms,21159916,0,0.0,21159916,100.0,2008
The Divine Weapon,19991573,0,0.0,19991573,100.0,2008
Jaane Tu... Ya Jaane Na,19852786,604037,3.0,19248749,97.0,2008
Blindness,19844979,3351751,16.9,16493228,83.1,2008
Il cosmo sul com√≤,19494191,0,0.0,19494191,100.0,2008
Lyubov 2 Morkov,19171562,0,0.0,19171562,100.0,2008
How to Lose Friends & Alienate People,19152009,2778752,14.5,16373257,85.5,2008
Avatar,2743577587,749766139,27.3,1993811448,72.7,2009
Harry Potter and the Half0Blood Prince,933959197,301959197,32.3,632000000,67.7,2009
Ice Age: Dawn of the Dinosaurs,886686817,196573705,22.2,690113112,77.8,2009
Transformers: Revenge of the Fallen,836303693,402111870,48.1,434191823,51.9,2009
2012,769679473,166112167,21.6,603567306,78.4,2009
Up,735099082,293004164,39.9,442094918,60.1,2009
The Twilight Saga: New Moon,709827462,296623634,41.8,413203828,58.2,2009
Sherlock Holmes,524028679,209028679,39.9,315000000,60.1,2009
Angels & Demons,485930816,133375846,27.4,352554970,72.6,2009
The Hangover,468812793,277322503,59.2,191490290,40.8,2009
Alvin and the Chipmunks: The Squeakquel,443140005,219614612,49.6,223525393,50.4,2009
Night at the Museum: Battle of the Smithsonian,413106170,177243721,42.9,235862449,57.1,2009
Star Trek,385680446,257730019,66.8,127950427,33.2,2009
Monsters vs. Aliens,381509870,198351526,52.0,183158344,48.0,2009
X0Men Origins: Wolverine,373062864,179883157,48.2,193179707,51.8,2009
Terminator Salvation,371353001,125322469,33.7,246030532,66.3,2009
Fast & Furious,360364265,155064265,43.0,205300000,57.0,2009
Prince of Persia: The Sands of Time,336365676,90759676,27.0,245606000,73.0,2009
A Christmas Carol,325286646,137855863,42.4,187430783,57.6,2009
Inglourious Basterds,321455689,120540719,37.5,200914970,62.5,2009
The Proposal,317375031,163958031,51.7,153417000,48.3,2009
The Blind Side,309208309,255959475,82.8,53248834,17.2,2009
G.I. Joe: The Rise of Cobra,302469017,150201498,49.7,152267519,50.3,2009
G0Force,292817841,119436770,40.8,173381071,59.2,2009
This Is It,267983588,72091016,26.9,195892572,73.1,2009
The Princess and the Frog,267045765,104400899,39.1,162644866,60.9,2009
Cloudy with a Chance of Meatballs,243006126,124870275,51.4,118135851,48.6,2009
It's Complicated,219103655,112735375,51.5,106368280,48.5,2009
Public Enemies,214104620,97104620,45.4,117000000,54.6,2009
District 9,210888950,115646235,54.8,95242715,45.2,2009
The Ugly Truth,205298907,88915214,43.3,116383693,56.7,2009
Paranormal Activity,193355800,107918810,55.8,85436990,44.2,2009
The Final Destination,186167139,66477700,35.7,119689439,64.3,2009
Watchmen,185382813,107509799,58.0,77873014,42.0,2009
Paul Blart: Mall Cop,183348429,146336178,79.8,37012251,20.2,2009
He's Just Not That Into You,178866158,93953653,52.5,84912505,47.5,2009
Couples Retreat,171844840,109204945,63.5,62639895,36.5,2009
Up in the Air,166842739,83823381,50.2,83019358,49.8,2009
Hannah Montana: The Movie,155545279,79576189,51.2,75969090,48.8,2009
The Taking of Pelham 123,150166126,65452312,43.6,84713814,56.4,2009
Br√ºno,138805831,60054530,43.3,78751301,56.7,2009
17 Again,136316880,64167069,47.1,72149811,52.9,2009
Julie & Julia,129540522,94125426,72.7,35415096,27.3,2009
The Fighter,129190869,93617009,72.5,35573860,27.5,2009
Law Abiding Citizen,127944208,73357727,57.3,54586481,42.7,2009
Coraline,124596837,75286229,60.4,49310608,39.6,2009
Surrogates,122444772,38577772,31.5,83867000,68.5,2009
Invictus,122233971,37491364,30.7,84742607,69.3,2009
Red Cliff II,120432178,0,0.0,120432178,100.0,2009
Hotel for Dogs,117252578,73034460,62.3,44218118,37.7,2009
Bride Wars,115375850,58715510,50.9,56660340,49.1,2009
Confessions of a Shopaholic,108394089,44277350,40.8,64116739,59.2,2009
Race to Witch Mountain,106387141,67172594,63.1,39214547,36.9,2009
Planet 51,105647102,42194060,39.9,63453042,60.1,2009
The Girl with the Dragon Tattoo,104414200,10095170,9.7,94319030,90.3,2009
Zombieland,102392080,75590286,73.8,26801794,26.2,2009
Ghosts of Girlfriends Past,102366815,55250026,54.0,47116789,46.0,2009
The Time Traveler's Wife,101344412,63414846,62.6,37929566,37.4,2009
My Bloody Valentine,100734718,51545952,51.2,49188766,48.8,2009
Where the Wild Things Are,100140096,77233467,77.1,22906629,22.9,2009
Old Dogs,96753696,49492060,51.2,47261636,48.8,2009
My Sister's Keeper,95714875,49200230,51.4,46514645,48.6,2009
Green Zone,94882549,35053660,36.9,59828889,63.1,2009
The Lovely Bones,93621340,44114232,47.1,49507108,52.9,2009
Underworld: Rise of the Lycans,92158961,45802315,49.7,46356646,50.3,2009
I Love You Man,91980359,71440011,77.7,20540348,22.3,2009
Friday the 13th,91509154,65002019,71.0,26507135,29.0,2009
Drag Me to Hell,90842646,42100625,46.3,48742021,53.7,2009
Madea Goes to Jail,90508336,90508336,100.0,0,0.0,2009
Rookies the Movie: Graduation,88055243,0,0.0,88055243,100.0,2009
State of Play,87812371,37017955,42.2,50794416,57.8,2009
Did You Hear About the Morgans?,85280250,29580087,34.7,55700163,65.3,2009
Duplicity,78176181,40572825,51.9,37603356,48.1,2009
Orphan,77912251,41596251,53.4,36316000,46.6,2009
The Haunting in Connecticut,77536359,55389516,71.4,22146843,28.6,2009
Fame,77211836,22455510,29.1,54756326,70.9,2009
The Unborn,76514050,42670410,55.8,33843640,44.2,2009
The Pink Panther 2,76025134,35922978,47.3,40102156,52.7,2009
Obsessed,73830347,68261644,92.5,5568703,7.5,2009
Funny People,71585235,51855045,72.4,19730190,27.6,2009
Tidal Wave,71283278,0,0.0,71283278,100.0,2009
The Men Who Stare at Goats,69095771,32428195,46.9,36667576,53.1,2009
Land of the Lost,68777554,49438370,71.9,19339184,28.1,2009
Saw VI,68234154,27693292,40.6,40540862,59.4,2009
The Girl Who Played with Fire,67153225,7638241,11.4,59514984,88.6,2009
Precious,63649529,47566524,74.7,16083005,25.3,2009
Little Nicholas,62792067,0,0.0,62792067,100.0,2009
Year One,62357900,43337279,69.5,19020621,30.5,2009
The Imaginarium of Doctor Parnassus,61808775,7689607,12.4,54119168,87.6,2009
Ninja Assassin,61601280,38122883,61.9,23478397,38.1,2009
500 Days of Summer,60722734,32391374,53.3,28331360,46.7,2009
3 Idiots,60262836,6532874,10.8,53729962,89.2,2009
The International,60253843,25450527,42.2,34803316,57.8,2009
Aliens in the Attic,57881056,25200412,43.5,32680644,56.5,2009
Vicky the Viking,56390258,0,0.0,56390258,100.0,2009
Under the Sea 3D,55902624,36262926,64.9,19639698,35.1,2009
Dragonball Evolution,55720772,9362785,16.8,46357987,83.2,2009
Nine,54004950,19676965,36.4,34327985,63.6,2009
Arthur and the Revenge of Maltazard,52377611,0,0.0,52377611,100.0,2009
Take Off,52141043,0,0.0,52141043,100.0,2009
Pok√©mon: Arceus and the Jewel of Life,52119081,0,0.0,52119081,100.0,2009
I Can Do Bad All by Myself,51733921,51733921,100.0,0,0.0,2009
Coco Before Chanel,50812934,6113834,12.0,44699100,88.0,2009
One Piece: Strong World,49271461,0,0.0,49271461,100.0,2009
Push,48858618,31811527,65.1,17047091,34.9,2009
9,48428063,31749894,65.6,16678169,34.4,2009
20th Century Boys 3: Redemption,48397818,0,0.0,48397818,100.0,2009
The Fourth Kind,47709193,25486040,53.4,22223153,46.6,2009
Crazy Heart,47405566,39464306,83.2,7941260,16.8,2009
Hachi: A Dog's Tale,46748131,0,0.0,46748131,100.0,2009
Fantastic Mr. Fox,46471023,21002919,45.2,25468104,54.8,2009
Rabbit Without Ears 2,46439905,0,0.0,46439905,100.0,2009
The Last House on the Left,45289053,32752215,72.3,12536838,27.7,2009
The Spy Next Door,45236543,24307086,53.7,20929457,46.3,2009
Nodame Cantabile: The Movie II,44879450,0,0.0,44879450,100.0,2009
Notorious,44420316,36843682,82.9,7576485,17.1,2009
The Girl Who Kicked the Hornet's Nest,44276335,5190196,11.7,39086139,88.3,2009
Brothers,43474578,28544157,65.7,14930421,34.3,2009
The Informant!,41771168,33316821,79.8,8454347,20.2,2009
The Uninvited,41633384,28596818,68.7,13036566,31.3,2009
Toy Story 2009 Re0release,41258298,30702446,74.4,10555852,25.6,2009
Evangelion: 2.0 You Can (Not) Advance,41162041,133640,0.3,41028401,99.7,2009
The Concert,41146351,657986,1.6,40488365,98.4,2009
Gamer,40828540,20534907,50.3,20293633,49.7,2009
All About Steve,40105542,33862903,84.4,6242639,15.6,2009
Astro Boy,39886986,19551067,49.0,20335919,51.0,2009
Detective Conan: The Raven Chaser,39664359,0,0.0,39664359,100.0,2009
Agora,39457342,619423,1.6,38837919,98.4,2009
Halloween II,39421467,33392973,84.7,6028494,15.3,2009
Cirque du Freak: The Vampire's Assistant,39291383,13869515,35.3,25421868,64.7,2009
Jeon Woochi,38681926,0,0.0,38681926,100.0,2009
The Soloist,38332994,31720158,82.7,6612836,17.3,2009
Amalfi: Rewards of the Goddess,37840539,0,0.0,37840539,100.0,2009
Broken Embraces,37472507,5014305,13.4,32458202,86.6,2009
Brooklyn's Finest,36440201,27163593,74.5,9276608,25.5,2009
The Boat That Rocked,36348784,8017917,22.1,28330867,77.9,2009
Love Happens,36088028,22965110,63.6,13122918,36.4,2009
Whatever Works,36020534,5306706,14.7,30713828,85.3,2009
The Secret in Their Eyes,35079650,6391436,18.2,28688214,81.8,2009
Crank: High Voltage,34572541,13684249,39.6,20888292,60.4,2009
Gokusen: The Movie,34117482,0,0.0,34117482,100.0,2009
The Box,33333531,15051977,45.2,18281554,54.8,2009
LOL (Laughing Out Loud),32764784,0,0.0,32764784,100.0,2009
Fighting,32482728,23091010,71.1,9391718,28.9,2009
The Invention of Lying,32406507,18451251,56.9,13955256,43.1,2009
April Bride,32112343,0,0.0,32112343,100.0,2009
Jennifer's Body,31556061,16204793,51.4,15351268,48.6,2009
Dance Flick,31439140,25662155,81.6,5776985,18.4,2009
A Serious Man,31430334,9228768,29.4,22201566,70.6,2009
The Stepfather,31198531,29062561,93.2,2135970,6.8,2009
Yatterman,30365792,0,0.0,30365792,100.0,2009
Natale a Beverly Hills,29976481,0,0.0,29976481,100.0,2009
Crows Zero II,29893636,0,0.0,29893636,100.0,2009
20th Century Boys 2: The Last Hope,29502213,0,0.0,29502213,100.0,2009
The Young Victoria,29181829,11001272,37.7,18180557,62.3,2009
New in Town,29010817,16734283,57.7,12276534,42.3,2009
The Unbroken,29000322,0,0.0,29000322,100.0,2009
Shorts,28972508,20919166,72.2,8053342,27.8,2009
Pope Joan,28748076,0,0.0,28748076,100.0,2009
Case 39,28190603,13261851,47.0,14928752,53.0,2009
Recep Ivedik 2,27699692,0,0.0,27699692,100.0,2009
The Road,27639579,8117000,29.4,19522579,70.6,2009
Sorority Row,27206120,11965282,44.0,15240838,56.0,2009
Observe and Report,26973554,24007324,89.0,2966230,11.0,2009
An Education,26096852,12574914,48.2,13521938,51.8,2009
Coco,25593707,0,0.0,25593707,100.0,2009
Doraemon the Movie: The New Records of Nobita's Spaceblazer,25422212,0,0.0,25422212,100.0,2009
Mt. Tsurugidake,25134437,0,0.0,25134437,100.0,2009
A Single Man,24964890,9176000,36.8,15788890,63.2,2009
Kaiji: The Ultimate Gambler,24709016,0,0.0,24709016,100.0,2009
If I Were You 2,24415116,0,0.0,24415116,100.0,2009
I Give My First Love to You,24051386,0,0.0,24051386,100.0,2009
Mao's Last Dancer,23914731,4817770,20.1,19096961,79.9,2009
Dark Planet,23772559,0,0.0,23772559,100.0,2009
Jonas Brothers: The 3D Concert Experience,23186960,19162740,82.6,4024220,17.4,2009
Imagine That,22985194,16123323,70.1,6861871,29.9,2009
Armored,22942221,15988876,69.7,6953345,30.3,2009
A Perfect Getaway,22938329,15515460,67.6,7422869,32.4,2009
Dorian Gray,22873653,0,0.0,22873653,100.0,2009
Men in the City,22420615,0,0.0,22420615,100.0,2009
Neuilly Yo Mama!,22243482,0,0.0,22243482,100.0,2009
OSS 117: Lost in Rio,21924245,89375,0.4,21834870,99.6,2009
The Rebound,21791288,0,0.0,21791288,100.0,2009
My Girlfriend Is an Agent,21056256,0,0.0,21056256,100.0,2009
Black Lightning,20984902,0,0.0,20984902,100.0,2009
Love Aaj Kal,20794985,2430083,11.7,18364902,88.3,2009
I Love You Phillip Morris,20768906,2037459,9.8,18731447,90.2,2009
Pandemic,20712567,0,0.0,20712567,100.0,2009
Pandorum,20648328,10330853,50.0,10317475,50.0,2009
My Life in Ruins,20455482,8665206,42.4,11790276,57.6,2009
Cado dalle nubi,20123466,0,0.0,20123466,100.0,2009
Solomon Kane,19652185,0,0.0,19652185,100.0,2009
Amelia,19643086,14246488,72.5,5396598,27.5,2009
Drop,19611028,0,0.0,19611028,100.0,2009
High Security Vacation,19487557,0,0.0,19487557,100.0,2009
Kamen Rider Decade: All Riders vs. Dai0Shocker,19418091,0,0.0,19418091,100.0,2009
Ballad,19328678,0,0.0,19328678,100.0,2009
The White Ribbon,19319671,2222862,11.5,17096809,88.5,2009
Cell 211,19300483,0,0.0,19300483,100.0,2009
Taras Bulba,18874808,0,0.0,18874808,100.0,2009
Toy Story 3,1066969703,415004880,38.9,651964823,61.1,2010
Alice in Wonderland,1025467110,334191110,32.6,691276000,67.4,2010
Harry Potter and the Deathly Hallows: Part 1,960283305,295983305,30.8,664300000,69.2,2010
Inception,828258695,292576195,35.3,535682500,64.7,2010
Shrek Forever After,752600867,238736787,31.7,513864080,68.3,2010
The Twilight Saga: Eclipse,698491347,300531751,43.0,397959596,57.0,2010
Iron Man 2,623933331,312433331,50.1,311500000,49.9,2010
Tangled,592461732,200821936,33.9,391639796,66.1,2010
Despicable Me,543239815,251639815,46.3,291600000,53.7,2010
How to Train Your Dragon,494878759,217581231,44.0,277297528,56.0,2010
Clash of the Titans,493214993,163214888,33.1,330000105,66.9,2010
The Chronicles of Narnia: The Voyage of the Dawn Treader,415686217,104386950,25.1,311299267,74.9,2010
The King's Speech,412018551,135453143,32.9,276565408,67.1,2010
Tron: Legacy,400062763,172062763,43.0,228000000,57.0,2010
The Karate Kid,359126022,176591618,49.2,182534404,50.8,2010
Black Swan,329398046,106954678,32.5,222443368,67.5,2010
Megamind,321885765,148415853,46.1,173469912,53.9,2010
Robin Hood,321669741,105269730,32.7,216400011,67.3,2010
The Last Airbender,319713881,131772187,41.2,187941694,58.8,2010
Little Fockers,310650585,148438600,47.8,162211985,52.2,2010
Resident Evil: Afterlife,300228084,60128566,20.0,240099518,80.0,2010
Shutter Island,294804195,128012934,43.4,166791261,56.6,2010
Salt,293503354,118311368,40.3,175191986,59.7,2010
Sex and the City 2,290745055,95347692,32.8,195397363,67.2,2010
The Tourist,278780441,67631157,24.3,211149284,75.7,2010
The Expendables,274470394,103068524,37.6,171401870,62.4,2010
Grown Ups,271430189,162001186,59.7,109429003,40.3,2010
Knight and Day 2010 Re0release,261930436,76423035,29.2,185507401,70.8,2010
True Grit,252276927,171243005,67.9,81033922,32.1,2010
Gulliver's Travels,237382724,42779261,18.0,194603463,82.0,2010
Percy Jackson & the Olympians: The Lightning Thief,226497209,88768303,39.2,137728906,60.8,2010
The Social Network,224920315,96962694,43.1,127957621,56.9,2010
Valentine's Day,216485654,110485654,51.0,106000000,49.0,2010
The Sorcerer's Apprentice,215283742,63150991,29.3,152132751,70.7,2010
Due Date,211780824,100539043,47.5,111241781,52.5,2010
Eat Pray Love,204594016,80574010,39.4,124020006,60.6,2010
Yogi Bear,203509374,100246011,49.3,103263363,50.7,2010
RED,199006387,90380162,45.4,108626225,54.6,2010
Paranormal Activity 2,177512032,84752907,47.7,92759125,52.3,2010
The A0Team,177238796,77222099,43.6,100016697,56.4,2010
Jackass 3D,171685792,117229692,68.3,54456100,31.7,2010
The Other Guys,170458922,119219978,69.9,51238944,30.1,2010
Unstoppable,167805466,81562942,48.6,86242524,51.4,2010
Step Up 3D,159291809,42400223,26.6,116891586,73.4,2010
The Book of Eli,157107755,94835059,60.4,62272696,39.6,2010
The Town,154026136,92186262,59.9,61839874,40.1,2010
Date Night,152263880,98711404,64.8,53552476,35.2,2010
The Secret World of Arrietty,148979794,19202743,12.9,129777051,87.1,2010
Legend of the Guardians: The Owls of Ga'Hoole,140073390,55675313,39.7,84398077,60.3,2010
The Wolfman,139789765,61979680,44.3,77810085,55.7,2010
The Bounty Hunter,136333522,67061228,49.2,69272294,50.8,2010
Saw 3D,136150434,45710178,33.6,90440256,66.4,2010
Wall Street: Money Never Sleeps,134748021,52474616,38.9,82273405,61.1,2010
The Adjustment Bureau,127869379,62495645,48.9,65373734,51.1,2010
Predators,127233108,52000688,40.9,75232420,59.1,2010
A Nightmare on Elm Street,115694863,63075011,54.5,52619852,45.5,2010
Dear John,114991723,80014842,69.6,34969824,30.4,2010
Cats & Dogs: The Revenge of Kitty Galore,112483764,43585753,38.7,68898011,61.3,2010
Tooth Fairy,112462508,60022256,53.4,52440252,46.6,2010
Sanctum,108609310,23209310,21.4,85400000,78.6,2010
Harmony,107056263,0,0.0,107056263,100.0,2010
Hereafter,106956330,32746941,30.6,74209389,69.4,2010
Life as We Know It,105734416,53374681,50.5,52359735,49.5,2010
Let the Bullets Fly,104723314,63012,0.0,104660302,99.9,2010
Love & Other Drugs,102820008,32367005,31.5,70453003,68.5,2010
Aftershock,100293273,62962,0.0,100230311,99.9,2010
Umizaru 3: The Last Message,98663381,0,0.0,98663381,100.0,2010
Killers,98159963,47059963,47.9,51100000,52.1,2010
Kick0Ass,96188903,48071303,50.0,48117600,50.0,2010
Nanny McPhee Returns,93251121,29011215,31.1,64239906,68.9,2010
Get Him to the Greek,91720255,60974475,66.5,30745780,33.5,2010
Burlesque,89519773,39440655,44.1,50079118,55.9,2010
The Last Song,89137047,62950384,70.6,26186663,29.4,2010
Dinner for Schmucks,86855739,73026337,84.1,13829402,15.9,2010
Bayside Shakedown 3: Set the Guys Loose,85347374,0,0.0,85347374,100.0,2010
Marmaduke,83761844,33644788,40.2,50117056,59.8,2010
Piranha 3D,83188165,25003155,30.1,58185010,69.9,2010
Oceans,83090556,19422319,23.4,63668237,76.6,2010
Blades of Blood 2010 Re0release,82177196,0,0.0,82177196,100.0,2010
Edge of Darkness,81126522,43313890,53.4,37812632,46.6,2010
Vampires Suck,80547866,36661504,45.5,43886362,54.5,2010
Letters to Juliet,79293444,53032453,66.9,26260991,33.1,2010
The Back0up Plan,77477008,37490007,48.4,39987001,51.6,2010
Diary of a Wimpy Kid,76196538,64003625,84.0,12192913,16.0,2010
If You Are the One 2,76085443,426894,0.6,75658549,99.4,2010
Easy A,75026216,58401464,77.8,16624752,22.2,2010
Hubble,74249729,52522904,70.7,21726825,29.3,2010
Pok√©mon: Zoroark: Master of Illusions,71143529,0,0.0,71143529,100.0,2010
A Turtle's Tale: Sammy's Adventures,70627617,0,0.0,70627617,100.0,2010
The Last Exorcism,69432527,41034350,59.1,28398177,40.9,2010
Takers,69055695,57744720,83.6,11310975,16.4,2010
Bestseller,68813389,0,0.0,68813389,100.0,2010
Legion,67918658,40168080,59.1,27750578,40.9,2010
The American,67876281,35606376,52.5,32269905,47.5,2010
The Next Three Days,67448651,21148651,31.4,46300000,68.6,2010
Skyline,66984887,21393620,31.9,45591267,68.1,2010
Hot Tub Time Machine,64735752,50287556,77.7,14448196,22.3,2010
Elite Squad 2: The Enemy Within,63618850,100119,0.2,63518731,99.8,2010
Devil,62695489,33601190,53.6,29094299,46.4,2010
127 Hours,60738797,18335230,30.2,42403567,69.8,2010
Why Did I Get Married Too?,60673972,60095852,99.0,578120,1.0,2010
The Ghost Writer,60331447,15541549,25.8,44789898,74.2,2010
Secretariat,60321861,59713955,99.0,607906,1.0,2010
Morning Glory,60040976,31011732,51.7,29029244,48.3,2010
Remember Me,56032889,19068240,34.0,36964649,66.0,2010
Cop Out,55611001,44875481,80.7,10735520,19.3,2010
Veda 0 Atat√ºrk,55024621,0,0.0,55024621,100.0,2010
The Crazies,54806823,39123589,71.4,15683234,28.6,2010
Little White Lies,53319615,206088,0.4,53113527,99.6,2010
From Paris with Love,52830951,24077427,45.6,28753524,54.4,2010
Detective Dee: The Mystery of the Phantom Flame,51899269,459836,0.9,51439433,99.1,2010
Conference of Animals,51883642,0,0.0,51883642,100.0,2010
Daybreakers,51416464,30101577,58.5,21314887,41.5,2010
Alpha and Omega,50507267,25107267,49.7,25400000,50.3,2010
The Switch,49830607,27779426,55.7,22051181,44.3,2010
Space Battleship Yamato,49827298,0,0.0,49827298,100.0,2010
She's Out of My League,49779728,32010860,64.3,17768868,35.7,2010
How Do You Know,48668907,30212620,62.1,18456287,37.9,2010
Charlie St. Cloud,48190704,31162545,64.7,17028159,35.3,2010
Heartbreaker,48023509,504030,1.0,47519479,99.0,2010
Scott Pilgrim vs. the World,47664559,31524275,66.1,16140284,33.9,2010
StreetDance 2,46960833,0,0.0,46960833,100.0,2010
Welcome to the South,45896492,0,0.0,45896492,100.0,2010
Machete,45491656,26593646,58.5,18898010,41.5,2010
Confessions,45203103,0,0.0,45203103,100.0,2010
Avatar 2010 Special Edition,44838548,10741486,24.0,34097062,76.0,2010
The Man from Nowhere,44723232,528175,1.2,44195057,98.8,2010
Of Gods and Men,43803417,3951596,9.0,39851821,91.0,2010
Boy,43551154,256211,0.6,43294943,99.4,2010
When in Rome,43053376,32680633,75.9,10372743,24.1,2010
My Name Is Khan,42345360,4018771,9.5,38326589,90.5,2010
Going the Distance,42059111,17804299,42.3,24254812,57.7,2010
Nodame Cantabile: The Movie II 2010 Re0release,41054604,0,0.0,41054604,100.0,2010
SP: The Motion Picture I,39674739,0,0.0,39674739,100.0,2010
Kokkuri0san: Gekij√¥0ban,37982240,0,0.0,37982240,100.0,2010
For Colored Girls,37981984,37729698,99.3,252286,0.7,2010
Detective Conan: The Lost Ship in the Sky,36407407,0,0.0,36407407,100.0,2010
Secret Reunion,36298578,0,0.0,36298578,100.0,2010
Furry Vengeance,36288132,17630465,48.6,18657667,51.4,2010
You Will Meet a Tall Dark Stranger,35867322,3248246,9.1,32619076,90.9,2010
Faster,35626958,23240020,65.2,12386938,34.8,2010
The Kids Are All Right,34705850,20811365,60.0,13894485,40.0,2010
Doraemon The Movie: Nobita's Great Battle of the Mermaid King,34702573,0,0.0,34702573,100.0,2010
The Extraordinary Adventures of Ad√®le Blanc0Sec,34604339,0,0.0,34604339,100.0,2010
Camping 2,33857735,0,0.0,33857735,100.0,2010
Arthur 3: The War of the Two Worlds,33519334,0,0.0,33519334,100.0,2010
Dogwood Tree,33016351,0,0.0,33016351,100.0,2010
Leap Year,32686500,25918920,79.3,6767580,20.7,2010
Potiche,32309881,1618844,5.0,30691037,95.0,2010
You Again,32054369,25702053,80.2,6352316,19.8,2010
Raajneeti,29459596,1514558,5.1,27945038,94.9,2010
The Losers,29397654,23591432,80.2,5806222,19.8,2010
The Santa Claus Gang,29181330,0,0.0,29181330,100.0,2010
Sacrifice,29093560,29792,0.1,29063768,99.9,2010
The Lady Shogun and Her Men,27769952,0,0.0,27769952,100.0,2010
Legend of the Fist: The Return of Chen Zhen,27390678,50433,0.2,27340245,99.8,2010
Ramona and Beezus,27293743,26167002,95.9,1126741,4.1,2010
Splice 2010 Re0release,27127620,17010170,62.7,10117450,37.3,2010
Let Me In,27093592,12134935,44.8,14958657,55.2,2010
Fair Game,25798915,9540691,37.0,16258224,63.0,2010
The Round Up,25623521,0,0.0,25623521,100.0,2010
Christmas in South Africa,25362517,0,0.0,25362517,100.0,2010
Biutiful,25147786,5101237,20.3,20046549,79.7,2010
Six Degrees of Celebration,25030264,0,0.0,25030264,100.0,2010
Sarah's Key,24792815,7693187,31.0,17099628,69.0,2010
Lottery Ticket,24719879,24719879,100.0,0,0.0,2010
Liar Game: The Final Stage,24658706,0,0.0,24658706,100.0,2010
The Way Back,24172201,2701859,11.2,21470342,88.8,2010
Nasha Russia. Yaytsa sudby,24022125,0,0.0,24022125,100.0,2010
Just Call Me Nobody,23705022,0,0.0,23705022,100.0,2010
Act of Vengeance,23423390,0,0.0,23423390,100.0,2010
Under the Hawthorn Tree,23004431,0,0.0,23004431,100.0,2010
Recep Ivedik 3,22588876,0,0.0,22588876,100.0,2010
Villain,22414467,0,0.0,22414467,100.0,2010
A Thousand Words,22044277,18450127,83.7,3594150,16.3,2010
Me Them and Lara,22039646,0,0.0,22039646,100.0,2010
Moss,21925534,0,0.0,21925534,100.0,2010
22 Bullets,21695883,0,0.0,21695883,100.0,2010
Inazuma Eleven GO the Movie: The Ultimate Bonds Gryphon,21645379,0,0.0,21645379,100.0,2010
Just Wright,21584424,21540363,99.8,44061,0.2,2010
My Soul to Take,21500813,14744435,68.6,6756378,31.4,2010
Our Family Wedding,21409028,20255281,94.6,1153747,5.4,2010
Astral City: A Spiritual Journey,21218935,0,0.0,21218935,100.0,2010
71: Into the Fire,20967660,176638,0.8,20791022,99.2,2010
Country Strong,20529194,20218921,98.5,310273,1.5,2010
Beck,20219060,0,0.0,20219060,100.0,2010
How Not to Rescue a Princess,20157447,0,0.0,20157447,100.0,2010
About Her Brother,19969473,0,0.0,19969473,100.0,2010
Trick the Movie: Psychic Battle Royale,19795115,0,0.0,19795115,100.0,2010
Hello Ghost,19774455,0,0.0,19774455,100.0,2010
Another Year,19722766,3205706,16.3,16517060,83.7,2010
Youth in Revolt,19651093,15281286,77.8,4369807,22.2,2010
Hot Summer Days,19573451,0,0.0,19573451,100.0,2010
Buried,19439764,1044143,5.4,18395621,94.6,2010
The Servant,19259164,0,0.0,19259164,100.0,2010
Norwegian Wood,19115721,13000,0.0,19102721,99.9,2010
13 Assassins,18689058,802778,4.3,17886280,95.7,2010
Green Zone 2010 Re0release,18495045,0,0.0,18495045,100.0,2010
Harry Potter and the Deathly Hallows: Part 2,1341511219,381011219,28.4,960500000,71.6,2011
Transformers: Dark of the Moon,1123794079,352390543,31.4,771403536,68.6,2011
Pirates of the Caribbean: On Stranger Tides,1045713802,241071802,23.1,804642000,76.9,2011
The Twilight Saga: Breaking Dawn 0 Part 1,712205856,281287133,39.5,430918723,60.5,2011
Mission: Impossible 0 Ghost Protocol,694713380,209397903,30.1,485315477,69.9,2011
Kung Fu Panda 2,665692281,165249063,24.8,500443218,75.2,2011
Fast Five,626137675,209837675,33.5,416300000,66.5,2011
The Hangover Part II,586764305,254464305,43.4,332300000,56.6,2011
The Smurfs,563749323,142614158,25.3,421135165,74.7,2011
Cars 2,559852396,191452396,34.2,368400000,65.8,2011
Puss in Boots,554987477,149260504,26.9,405726973,73.1,2011
Sherlock Holmes: A Game of Shadows,543848418,186848418,34.4,357000000,65.6,2011
Rio,483866518,143619809,29.7,340246709,70.3,2011
Rise of the Planet of the Apes,481800873,176760185,36.7,305040688,63.3,2011
Thor,449326618,181030624,40.3,268295994,59.7,2011
The Intouchables,426588510,10198820,2.4,416389690,97.6,2011
The Adventures of Tintin,373993951,77591831,20.7,296402120,79.3,2011
Captain America: The First Avenger,370569774,176654505,47.7,193915269,52.3,2011
X0Men: First Class,352616690,146408305,41.5,206208385,58.5,2011
Alvin and the Chipmunks: Chipwrecked,342695435,133110742,38.8,209584693,61.2,2011
Real Steel,299268508,85468508,28.6,213800000,71.4,2011
Bridesmaids,288383523,169106725,58.6,119276798,41.4,2011
Super 8,260095986,127004179,48.8,133091807,51.2,2011
Rango,245724603,123477607,50.3,122246996,49.7,2011
Green Lantern,237201172,116601172,49.2,120600000,50.8,2011
The Green Hornet,227817248,98780042,43.4,129037206,56.6,2011
Immortals,226904017,83504017,36.8,143400000,63.2,2011
The Help,216639112,169708112,78.3,46931000,21.7,2011
Bad Teacher,216197492,100292856,46.4,115904636,53.6,2011
Just Go with It,214945591,103028109,47.9,111917482,52.1,2011
Battle Los Angeles,211819354,83552429,39.4,128266925,60.6,2011
Horrible Bosses,209838559,117538559,56.0,92300000,44.0,2011
Paranormal Activity 3,207039844,104028807,50.2,103011037,49.8,2011
Gnomeo & Juliet,193967670,99967670,51.5,94000000,48.5,2011
Mr. Popper's Penguins,187361754,68224452,36.4,119137302,63.6,2011
The Lion King 2011 3D Release,186042001,94242001,50.7,91800000,49.3,2011
Hugo,185770160,73864507,39.8,111905653,60.2,2011
Hop,183953723,108085305,58.8,75868418,41.2,2011
War Horse,177584879,79884879,45.0,97700000,55.0,2011
The Descendants,177243185,82584160,46.6,94659025,53.4,2011
Cowboys & Aliens,174822325,100240551,57.3,74581774,42.7,2011
In Time,173930596,37520095,21.6,136410501,78.4,2011
Zookeeper,169852759,80360843,47.3,89491916,52.7,2011
The Muppets,165184237,88631237,53.7,76553000,46.3,2011
Limitless,161849455,79249455,49.0,82600000,51.0,2011
Johnny English Reborn,160078586,8305970,5.2,151772616,94.8,2011
Happy Feet Two,159196259,64006466,40.2,95189793,59.8,2011
Final Destination 5,157887643,42587643,27.0,115300000,73.0,2011
Tower Heist,152930623,78046570,51.0,74884053,49.0,2011
Midnight in Paris,151672318,56817045,37.5,94855273,62.5,2011
I Am Number Four,149878437,55100437,36.8,94778000,63.2,2011
Jack and Jill,149673788,74158157,49.5,75515631,50.5,2011
Friends with Benefits,149542245,55802754,37.3,93739491,62.7,2011
No Strings Attached,149228077,70662220,47.4,78565857,52.6,2011
Arthur Christmas,147419472,46462469,31.5,100957003,68.5,2011
Source Code,147332697,54712227,37.1,92620470,62.9,2011
Crazy Stupid Love.,145051197,84351197,58.2,60700000,41.8,2011
New Year's Eve,142044638,54544638,38.4,87500000,61.6,2011
Contagion,136515867,75658097,55.4,60857770,44.6,2011
Unknown,135710029,63686397,46.9,72023632,53.1,2011
The Artist,133432856,44671682,33.5,88761174,66.5,2011
The Three Musketeers,132274484,20374484,15.4,111900000,84.6,2011
We Bought a Zoo,120081841,75624550,63.0,44457291,37.0,2011
Hankyu Railways 0 A 150minute Miracle,118799256,0,0.0,118799256,100.0,2011
Water for Elephants,117094902,58709717,50.1,58385185,49.9,2011
The Iron Lady,115890699,30017992,25.9,85872707,74.1,2011
Moneyball,110206216,75605492,68.6,34600724,31.4,2011
Insidious,99557032,54009150,54.2,45547882,45.8,2011
Justin Bieber: Never Say Never,99036827,73013910,73.7,26022917,26.3,2011
Paul,97984015,37412945,38.2,60571070,61.8,2011
Scream 4,97138686,38180928,39.3,58957758,60.7,2011
The Rite,96560591,33047633,34.2,63512958,65.8,2011
Dolphin Tale,95932565,72286779,75.4,23645786,24.6,2011
Nothing to Declare,93811164,0,0.0,93811164,100.0,2011
Season of the Witch,91627228,24827228,27.1,66800000,72.9,2011
Red Riding Hood,90260376,37662162,41.7,52598214,58.3,2011
Sucker Punch,89792502,36392502,40.5,53400000,59.5,2011
The Inbetweeners,88823111,36000,0.0,88787111,100.0,2011
The Lincoln Lawyer,86752352,58009200,66.9,28743152,33.1,2011
Hall Pass,86157237,45060734,52.3,41096503,47.7,2011
Spy Kids 4: All the Time in the World,85564310,38538188,45.0,47026122,55.0,2011
J. Edgar,84920539,37306030,43.9,47614509,56.1,2011
Big Mommas: Like Father Like Son,82686066,37915414,45.9,44770652,54.1,2011
Abduction,82087155,28087155,34.2,54000000,65.8,2011
Tinker Tailor Soldier Spy,81244605,24149393,29.7,57095212,70.3,2011
Priest,78309505,29137000,37.2,49172505,62.8,2011
The Ides of March,76338111,40962534,53.7,35375577,46.3,2011
Drive,76280348,35061555,46.0,41218793,54.0,2011
The Mechanic,76130093,29121498,38.3,47008595,61.7,2011
The Change0Up,75450437,37081475,49.1,38368962,50.9,2011
Larry Crowne,75055070,35608245,47.4,39446825,52.6,2011
Diary of a Wimpy Kid: Rodrick Rules,72526996,52698535,72.7,19828461,27.3,2011
The Dilemma,69721966,48475290,69.5,21246676,30.5,2011
Something Borrowed,65100369,39046489,60.0,26053880,40.0,2011
The Darkest Hour,64626786,21443494,33.2,43183292,66.8,2011
Hanna,63782078,40259119,63.1,23522959,36.9,2011
Footloose 2011 Re0release,63543328,51802742,81.5,11740586,18.5,2011
Conan the Barbarian,63523283,21295021,33.5,42228262,66.5,2011
Colombiana,63458440,36665854,57.8,26792586,42.2,2011
From Up on Poppy Hill,61459425,1002895,1.6,60456530,98.4,2011
What a Beautiful Day,60661950,0,0.0,60661950,100.0,2011
One Day,59389433,13843771,23.3,45545662,76.7,2011
The Tree of Life,58385840,13303319,22.8,45082521,77.2,2011
Beginning of the Great Revival,58309289,151000,0.3,58158289,99.7,2011
Killer Elite,57084522,25124966,44.0,31959556,56.0,2011
Gekijouban Tenpesuto 3D,57082491,0,0.0,57082491,100.0,2011
Silent Hill: Revelation,55362705,17529157,31.7,37833548,68.3,2011
Extremely Loud & Incredibly Close,55247881,31847881,57.6,23400000,42.4,2011
Madea's Big Happy Family,54161287,53345287,98.5,816000,1.5,2011
A Ghost of a Chance,53982636,0,0.0,53982636,100.0,2011
Sunny,51116421,0,0.0,51116421,100.0,2011
War of the Arrows,50587661,251200,0.5,50336461,99.5,2011
Kokow√§√§h,50447784,0,0.0,50447784,100.0,2011
Winnie the Pooh,49871429,26692846,53.5,23178583,46.5,2011
Arthur,48147945,33035397,68.6,15112548,31.4,2011
Soul Surfer,47120948,43853424,93.1,3267524,6.9,2011
The Debt,45636368,31177548,68.3,14458820,31.7,2011
Beastly,43202283,27865571,64.5,15336712,35.5,2011
Detective Conan: Quarter of Silence,42808575,0,0.0,42808575,100.0,2011
Shaolin,42741494,66099,0.2,42675395,99.8,2011
Born to Be Wild,41644475,25978556,62.4,15665919,37.6,2011
Shark Night,41363927,18877153,45.6,22486774,54.4,2011
50/50,41097853,35014192,85.2,6083661,14.8,2011
Fright Night,41002607,18302607,44.6,22700000,55.4,2011
Drive Angry,40909909,10721033,26.2,30188876,73.8,2011
30 Minutes or Less,40662632,37053924,91.1,3608708,8.9,2011
Gantz,40568961,0,0.0,40568961,100.0,2011
The Roommate,40492652,37300000,92.1,3192652,7.9,2011
SP: The Motion Picture II,40255101,0,0.0,40255101,100.0,2011
Dream House,39984400,21302340,53.3,18682060,46.7,2011
Monte Carlo,39782683,23186769,58.3,16595914,41.7,2011
Kaibutsu0kun: The Movie,39766344,0,0.0,39766344,100.0,2011
Mars Needs Moms,39233678,21392758,54.5,17840920,45.5,2011
The Crown Jewels,39000000,0,0.0,39000000,100.0,2011
Don't Be Afraid of the Dark,38269529,24046682,62.8,14222847,37.2,2011
Jumping the Broom,38158601,37295394,97.7,863207,2.3,2011
One for the Money,38080789,26414527,69.4,11666262,30.6,2011
The Eagle,37989684,19490041,51.3,18499643,48.7,2011
A Very Harold & Kumar Christmas,36192775,35061031,96.9,1131744,3.1,2011
Ra.One,35911689,2511689,7.0,33400000,93.0,2011
Courageous,35185884,34522221,98.1,663663,1.9,2011
My Week with Marilyn,35057696,14600347,41.6,20457349,58.4,2011
The Sitter,34942188,30441326,87.1,4500862,12.9,2011
Jane Eyre,34710627,11242660,32.4,23467967,67.6,2011
The Skin I Live In,33678406,3185812,9.5,30492594,90.5,2011
Gantz: Perfect Answer,33672515,0,0.0,33672515,100.0,2011
Punch,33556725,0,0.0,33556725,100.0,2011
Detective K: Secret of Virtuous Widow,32358664,0,0.0,32358664,100.0,2011
Bodyguard,31516209,1834384,5.8,29681825,94.2,2011
The Thing,31505287,16928670,53.7,14576617,46.3,2011
I Don't Know How She Does It,31410151,9662284,30.8,21747867,69.2,2011
All's Well Ends Well 2011,31335572,0,0.0,31335572,100.0,2011
Vysotsky. Thank You for Being Alive,31016553,0,0.0,31016553,100.0,2011
Silenced,30996130,0,0.0,30996130,100.0,2011
African Cats,30857747,15428747,50.0,15429000,50.0,2011
A Dangerous Method,30519436,5704709,18.7,24814727,81.3,2011
What's Your Number?,30426096,14011084,46.0,16415012,54.0,2011
Doraemon: Nobita and the New Steel Troops: ~Winged Angels~,30236973,0,0.0,30236973,100.0,2011
Eternal Moment,30186159,0,0.0,30186159,100.0,2011
The Rum Diary,30134958,13109815,43.5,17025143,56.5,2011
My Own Swordsman,30082188,0,0.0,30082188,100.0,2011
Carnage,30035601,2547047,8.5,27488554,91.5,2011
You Are the Apple of My Eye,29843025,0,0.0,29843025,100.0,2011
Torrente 4: Lethal Crisis,29737384,0,0.0,29737384,100.0,2011
The Sorcerer and the White Snake,29649716,0,0.0,29649716,100.0,2011
Unfair: The Answer,29166054,0,0.0,29166054,100.0,2011
Dragon,29140858,0,0.0,29140858,100.0,2011
Yolki 2,28719002,0,0.0,28719002,100.0,2011
Your Highness,28013733,21596445,77.1,6417288,22.9,2011
Love Strikes!,27707149,0,0.0,27707149,100.0,2011
The Women on the 6th Floor,27533970,719823,2.6,26814147,97.4,2011
Letters to Santa,26923513,0,0.0,26923513,100.0,2011
A Monster in Paris,26710392,0,0.0,26710392,100.0,2011
Ivan Tsarevich & the Grey Wolf,26420475,0,0.0,26420475,100.0,2011
Apollo 18,26236153,17687709,67.4,8548444,32.6,2011
Our Idiot Brother,25804448,24816118,96.2,988330,3.8,2011
Eyyvah Eyvah 2,24792348,0,0.0,24792348,100.0,2011
Ready,24663361,955148,3.9,23708213,96.1,2011
In His Chart,23384864,0,0.0,23384864,100.0,2011
Warrior,23308615,13657115,58.6,9651500,41.4,2011
Hoodwinked Too! Hood vs. Evil,23167844,10143779,43.8,13024065,56.2,2011
Young Adult,22939027,16311571,71.1,6627456,28.9,2011
Andalucia: Revenge of the Goddess,22929221,0,0.0,22929221,100.0,2011
A Separation,22926076,7099055,31.0,15827021,69.0,2011
Qualunquemente,22862029,0,0.0,22862029,100.0,2011
Friends: Naki on the Monster Island,22537428,0,0.0,22537428,100.0,2011
Kamen Rider OOO Wonderful: The Shogun and the 21 Core Medals,22313925,0,0.0,22313925,100.0,2011
Gooische vrouwen,22194574,0,0.0,22194574,100.0,2011
The Immature,21858834,0,0.0,21858834,100.0,2011
Pleasant Goat and Big Big Wolf 3,21847806,0,0.0,21847806,100.0,2011
Quick,21561934,0,0.0,21561934,100.0,2011
K0On! The Movie,21434003,0,0.0,21434003,100.0,2011
Red Dog,21185162,0,0.0,21185162,100.0,2011
Vicky and the Treasure of the Gods,20796153,0,0.0,20796153,100.0,2011
The Front Line,20629645,11018,0.0,20618627,99.9,2011
Polisse,20590872,211440,1.0,20379432,99.0,2011
Hollywoo,20587850,0,0.0,20587850,100.0,2011
Scabbard Samurai,20251745,0,0.0,20251745,100.0,2011
Kaiji 2: The Ultimate Gambler,19971259,0,0.0,19971259,100.0,2011
The Avengers,1518812988,623357910,41.0,895455078,59.0,2012
Skyfall,1108561013,304360277,27.5,804200736,72.5,2012
The Dark Knight Rises,1084939099,448139099,41.3,636800000,58.7,2012
The Hobbit: An Unexpected Journey,1017003568,303003568,29.8,714000000,70.2,2012
Ice Age: Continental Drift,877244782,161321843,18.4,715922939,81.6,2012
The Twilight Saga: Breaking Dawn 0 Part 2,829746820,292324737,35.2,537422083,64.8,2012
The Amazing Spider0Man,757930663,262030663,34.6,495900000,65.4,2012
Madagascar 3: Europe's Most Wanted,746921274,216391482,29.0,530529792,71.0,2012
The Hunger Games,694394724,408010692,58.8,286384032,41.2,2012
Men in Black¬≥,654213485,179020854,27.4,475192631,72.6,2012
Life of Pi,609016565,124987023,20.5,484029542,79.5,2012
Ted,549368315,218815487,39.8,330552828,60.2,2012
Brave,538983207,237283207,44.0,301700000,56.0,2012
Wreck0It Ralph,471222889,189422889,40.2,281800000,59.8,2012
Les Mis√©rables,442299309,148809770,33.6,293489539,66.4,2012
Django Unchained,425368238,162805434,38.3,262562804,61.7,2012
Prometheus,403354469,126477084,31.4,276877385,68.6,2012
Snow White and the Huntsman,396592829,155332381,39.2,241260448,60.8,2012
Taken 2,376141306,139854287,37.2,236287019,62.8,2012
Hotel Transylvania,358375603,148313048,41.4,210062555,58.6,2012
Titanic 2012 3D Release,350449521,57884114,16.5,292565407,83.5,2012
The Lorax,348961366,214151550,61.4,134809816,38.6,2012
Journey 2: The Mysterious Island,335260290,103860290,31.0,231400000,69.0,2012
The Expendables 2,314975955,85028192,27.0,229947763,73.0,2012
Rise of the Guardians,306941670,103412758,33.7,203528912,66.3,2012
Battleship,303025485,65422625,21.6,237602860,78.4,2012
Wrath of the Titans,301970083,83670083,27.7,218300000,72.3,2012
John Carter,284139100,73078100,25.7,211061000,74.3,2012
The Bourne Legacy,276144750,113203870,41.0,162940880,59.0,2012
Lincoln,275293450,182207973,66.2,93085477,33.8,2012
We're the Millers,269994119,150394119,55.7,119600000,44.3,2012
Dark Shadows,245527149,79727149,32.5,165800000,67.5,2012
Resident Evil: Retribution,240159255,42345531,17.6,197813724,82.4,2012
Silver Linings Playbook,236412453,132092958,55.9,104319495,44.1,2012
American Reunion,234989584,57011521,24.3,177978063,75.7,2012
Argo,232325503,136025503,58.5,96300000,41.5,2012
Jack Reacher,218340595,80070736,36.7,138269859,63.3,2012
Safe House,208076205,126373434,60.7,81702771,39.3,2012
21 Jump Street,201585328,138447667,68.7,63137661,31.3,2012
Total Recall,198467168,58877969,29.7,139589199,70.3,2012
The Impossible,198087212,19019882,9.6,179067330,90.4,2012
Lost in Thailand,197757387,57387,0.0,197700000,100.0,2012
The Vow,196114570,125014030,63.7,71100540,36.3,2012
Mirror Mirror,183018522,64935167,35.5,118083355,64.5,2012
The Dictator,179379533,59650222,33.3,119729311,66.7,2012
Looper,176506819,66486205,37.7,110020614,62.3,2012
Chinese Zodiac,170525083,0,0.0,170525083,100.0,2012
Magic Mike,167221571,113721571,68.0,53500000,32.0,2012
Flight,161772375,93772375,58.0,68000000,42.0,2012
Underworld: Awakening,160112671,62321039,38.9,97791632,61.1,2012
This Means War,156491279,54760791,35.0,101730488,65.0,2012
Paranormal Activity 4,142802657,53885000,37.7,88917657,62.3,2012
Step Up Revolution,140470746,35074677,25.0,105396069,75.0,2012
The Best Exotic Marigold Hotel,136836156,46412041,33.9,90424115,66.1,2012
The Wind Rises,136483439,5209580,3.8,131273859,96.2,2012
Last Vegas,134402450,63914167,47.6,70488283,52.4,2012
Zero Dark Thirty,132820716,95720716,72.1,37100000,27.9,2012
Ghost Rider: Spirit of Vengeance,132563930,51774002,39.1,80789928,60.9,2012
Cloud Atlas,130482868,27108272,20.8,103374596,79.2,2012
The Woman in Black,128955898,54333290,42.1,74622608,57.9,2012
Chronicle,126636097,64575175,51.0,62060922,49.0,2012
Walking with Dinosaurs 3D,126546518,36076121,28.5,90470397,71.5,2012
The Pirates! Band of Misfits,123054041,31051126,25.2,92002915,74.8,2012
Parental Guidance,119772232,77267296,64.5,42504936,35.5,2012
Abraham Lincoln: Vampire Hunter,116471580,37519139,32.2,78952441,67.8,2012
Pitch Perfect,115350426,65001093,56.4,50349333,43.6,2012
Hope Springs,114281051,63536011,55.6,50745040,44.4,2012
ParaNorman,107139399,56003051,52.3,51136348,47.7,2012
The Campaign,104907746,86907746,82.8,18000000,17.2,2012
Star Wars: Episode I 0 The Phantom Menace 2012 3D Release,102741546,43458335,42.3,59283211,57.7,2012
Project X,102731865,54731865,53.3,48000000,46.7,2012
The Devil Inside,101758490,53261944,52.3,48496546,47.7,2012
The Lucky One,99357138,60457138,60.8,38900000,39.2,2012
Contraband,96262212,66528000,69.1,29734212,30.9,2012
Think Like a Man,96070507,91547205,95.3,4523302,4.7,2012
Masquerade,94268432,922921,1.0,93345511,99.0,2012
Brave Hearts: Umizaru,91884352,0,0.0,91884352,100.0,2012
This Is 40,88215156,67544505,76.6,20670651,23.4,2012
The Thieves,87126367,685839,0.8,86440528,99.2,2012
The Possession,85446075,49130154,57.5,36315921,42.5,2012
What to Expect When You're Expecting,84384002,41152203,48.8,43231799,51.2,2012
Savages,82966152,47382068,57.1,35584084,42.9,2012
Sinister,82515113,48086903,58.3,34428210,41.7,2012
Act of Valor,82497035,70012847,84.9,12484188,15.1,2012
Frankenweenie,81491068,35291068,43.3,46200000,56.7,2012
The Grey,79781695,51580236,64.7,28201459,35.3,2012
Diary of a Wimpy Kid: Dog Days,77229695,49008662,63.5,28221033,36.5,2012
Thermae Romae,74285251,0,0.0,74285251,100.0,2012
One Piece Film Z,74223861,0,0.0,74223861,100.0,2012
To Rome with Love,73244881,16685867,22.8,56559014,77.2,2012
Here Comes the Boom,73100172,45290318,62.0,27809854,38.0,2012
Bayside Shakedown the Final,72867395,0,0.0,72867395,100.0,2012
The Cabin in the Woods,69935600,42073277,60.2,27862323,39.8,2012
Finding Nemo 2012 3D Release,69328283,41128283,59.3,28200000,40.7,2012
Anna Karenina,68929150,12816367,18.6,56112783,81.4,2012
The Watch,68267862,35353000,51.8,32914862,48.2,2012
Moonrise Kingdom,68263166,45512466,66.7,22750700,33.3,2012
The Secret of the Gods,67537798,0,0.0,67537798,100.0,2012
Madea's Witness Protection,66899242,65653242,98.1,1246000,1.9,2012
Beauty and the Beast 2012 3D Release,62008601,47617067,76.8,14391534,23.2,2012
Ast√©rix and Ob√©lix: God Save Britannia,61319383,0,0.0,61319383,100.0,2012
Evangelion: 3.0 You Can (Not) Redo,60488344,174945,0.3,60313399,99.7,2012
Quartet,59520298,18390117,30.9,41130181,69.1,2012
Rock of Ages,59418613,38518613,64.8,20900000,35.2,2012
That's My Boy,57719093,36931089,64.0,20788004,36.0,2012
The Odd Life of Timothy Green,56012642,51854875,92.6,4157767,7.4,2012
Lawless,55404159,37400127,67.5,18004032,32.5,2012
End of Watch,55078146,41003371,74.4,14074775,25.6,2012
Wolf Children,54984346,0,0.0,54984346,100.0,2012
The Three Stooges,54819301,44338224,80.9,10481077,19.1,2012
The Five0Year Engagement,54169363,28835528,53.2,25333835,46.8,2012
Red Dawn,50950296,44806783,87.9,6143513,12.1,2012
Red Tails,50365498,49876377,99.0,489121,1.0,2012
Monsters Inc. 2012 3D Release,50207820,34043006,67.8,16164814,32.2,2012
HOUBA! On the Trail of the Marsupilami,50146474,0,0.0,50146474,100.0,2012
Tad: The Lost Explorer,49491464,0,0.0,49491464,100.0,2012
A Turtle's Tale 2: Sammy's Escape from Paradise,49261830,0,0.0,49261830,100.0,2012
Trouble with the Curve,48963137,35763137,73.0,13200000,27.0,2012
Man on a Ledge,47636031,18620000,39.1,29016031,60.9,2012
A Werewolf Boy,46282588,342922,0.7,45939666,99.3,2012
Doraemon: Nobita and the Island of Miracles ~Animal Adventure~,46180706,0,0.0,46180706,100.0,2012
Gekijouban Tenpesuto 3D 2012 Re0release,46008255,0,0.0,46008255,100.0,2012
Detective Conan: The Eleventh Striker,44369456,0,0.0,44369456,100.0,2012
House at the End of the Street,44287131,31611916,71.4,12675215,28.6,2012
The Guilt Trip,41863726,37134215,88.7,4729511,11.3,2012
Safe,41564670,17142080,41.2,24422590,58.8,2012
Dredd,41037742,13414714,32.7,27623028,67.3,2012
La v√©rit√© si je mens! 3,40928635,0,0.0,40928635,100.0,2012
Always: Sunset on Third Street '64,40923305,0,0.0,40923305,100.0,2012
Chernobyl Diaries,38390020,18119640,47.2,20270380,52.8,2012
Killing Them Softly,37930465,15026056,39.6,22904409,60.4,2012
Rurouni Kenshin Part I: Origins,37654579,0,0.0,37654579,100.0,2012
The Tower,36512327,0,0.0,36512327,100.0,2012
Conquest 1453,35797045,35730,0.0,35761315,99.9,2012
Good Deeds,35579177,35025791,98.4,553386,1.6,2012
Arbitrage,35485056,7919574,22.3,27565482,77.7,2012
Welcome to the North,34995189,0,0.0,34995189,100.0,2012
Chimpanzee,34823764,28972764,83.2,5851000,16.8,2012
Alex Cross,34618867,25888412,74.8,8730455,25.2,2012
Salmon Fishing in the Yemen,34564651,9047981,26.2,25516670,73.8,2012
Haywire,34513760,18942396,54.9,15571364,45.1,2012
Adventures in Zambezia,34428345,0,0.0,34428345,100.0,2012
Cirque du Soleil: Worlds Away,34153101,12512862,36.6,21640239,63.4,2012
Three Heroes on Distant Shores,33674759,0,0.0,33674759,100.0,2012
2016: Obama's America,33449086,33449086,100.0,0,0.0,2012
The Perks of Being a Wallflower,33384127,17742948,53.1,15641179,46.9,2012
Lockout,32948113,14326864,43.5,18621249,56.5,2012
Katy Perry: Part of Me,32726956,25326071,77.4,7400885,22.6,2012
Nameless Gangster: Rules of the Time,32472645,0,0.0,32472645,100.0,2012
Movie 43,32438988,8840453,27.3,23598535,72.7,2012
The Floating Castle,31967471,0,0.0,31967471,100.0,2012
The Neighbors,31949315,0,0.0,31949315,100.0,2012
The Dream Team,31822402,0,0.0,31822402,100.0,2012
What's in a Name?,31303580,8111,0.0,31295469,100.0,2012
Joyful Noise,31158113,30932113,99.3,226000,0.7,2012
Premium Rush,31083599,20275446,65.2,10808153,34.8,2012
Playing for Keeps,30962335,13103272,42.3,17859063,57.7,2012
The Four,30505808,0,0.0,30505808,100.0,2012
The Grand Heist,30158762,0,0.0,30158762,100.0,2012
The Raven,29699345,16008272,53.9,13691073,46.1,2012
Amour,29652180,6739492,22.7,22912688,77.3,2012
All About My Wife,29382038,0,0.0,29382038,100.0,2012
Seven Psychopaths,29347202,15024049,51.2,14323153,48.8,2012
Rowdy Rathore,29342463,777373,2.6,28565090,97.4,2012
SPEC: Heaven,29023960,0,0.0,29023960,100.0,2012
We Were There: True Love,28876929,0,0.0,28876929,100.0,2012
Bol Bachchan,28775262,1216258,4.2,27559004,95.8,2012
Deranged,28444173,0,0.0,28444173,100.0,2012
The Master,28258060,16377274,58.0,11880786,42.0,2012
Hitchcock,27039669,6008677,22.2,21030992,77.8,2012
Dearest,26723916,0,0.0,26723916,100.0,2012
Architecture 101,26642354,0,0.0,26642354,100.0,2012
Dancing Queen,26411266,0,0.0,26411266,100.0,2012
Lesson of the Evil,26167224,0,0.0,26167224,100.0,2012
Agneepath,26001696,1986748,7.6,24014948,92.4,2012
Rust and Bone,25807712,2062027,8.0,23745685,92.0,2012
Head Over Heels 2,25402893,0,0.0,25402893,100.0,2012
On the Other Side of the Tracks,25109572,9572,0.0,25100000,100.0,2012
Helter Skelter,25066699,0,0.0,25066699,100.0,2012
The Last Tycoon,25009914,0,0.0,25009914,100.0,2012
Housefull 2,24922847,1791780,7.2,23131067,92.8,2012
Big Miracle,24719215,20157300,81.5,4561915,18.5,2012
Sparkle,24637800,24397469,99.0,240331,1.0,2012
The Players,24629152,10854,0.0,24618298,100.0,2012
Liar Game: Reborn,24549726,0,0.0,24549726,100.0,2012
I Want You,23961214,0,0.0,23961214,100.0,2012
Turkish for Beginners,23952712,0,0.0,23952712,100.0,2012
Wanderlust,23812816,17450535,73.3,6362281,26.7,2012
Little Brother Big Trouble: A Christmas Adventure,23785681,0,0.0,23785681,100.0,2012
To the Arctic 3D,23695388,14560838,61.5,9134550,38.5,2012
Hotaru the Movie: It's Only a Little Light in My Life,22975341,0,0.0,22975341,100.0,2012
Kon0Tiki,22842887,1517410,6.6,21325477,93.4,2012
Fall in Love Like a Star,22640355,0,0.0,22640355,100.0,2012
Upside Down,22187813,105095,0.5,22082718,99.5,2012
Unbowed,22132903,0,0.0,22132903,100.0,2012
Confession of Murder,21701525,0,0.0,21701525,100.0,2012
StreetDance 2 2012 Re0release,21638853,0,0.0,21638853,100.0,2012
2012 2012 Re0release,21538353,0,0.0,21538353,100.0,2012
Beasts of the Southern Wild,21107746,12795746,60.6,8312000,39.4,2012
Frozen,1280802282,400738009,31.3,880064273,68.7,2013
Iron Man 3,1214811252,409013994,33.7,805797258,66.3,2013
Despicable Me 2,970766005,368065385,37.9,602700620,62.1,2013
The Hobbit: The Desolation of Smaug,958366855,258366855,27.0,700000000,73.0,2013
The Hunger Games: Catching Fire,865011746,424668047,49.1,440343699,50.9,2013
Fast & Furious 6,788679850,238679850,30.3,550000000,69.7,2013
Monsters University,743559607,268492764,36.1,475066843,63.9,2013
Gravity,723192705,274092705,37.9,449100000,62.1,2013
Man of Steel,670145518,291045518,43.4,379100000,56.6,2013
Thor: The Dark World,644783140,206362140,32.0,438421000,68.0,2013
The Croods,587204668,187168425,31.9,400036243,68.1,2013
World War Z,540007876,202359711,37.5,337648165,62.5,2013
Oz the Great and Powerful,493311825,234911825,47.6,258400000,52.4,2013
Star Trek Into Darkness,467365246,228778661,49.0,238586585,51.0,2013
The Wolverine,414828246,132556852,32.0,282271394,68.0,2013
Pacific Rim,411002906,101802906,24.8,309200000,75.2,2013
The Wolf of Wall Street,392000694,116900694,29.8,275100000,70.2,2013
G.I. Joe: Retaliation,375740705,122523060,32.6,253217645,67.4,2013
The Hangover Part III,362000072,112200072,31.0,249800000,69.0,2013
The Great Gatsby,353641895,144840419,41.0,208801476,59.0,2013
Now You See Me,351723989,117723989,33.5,234000000,66.5,2013
The Smurfs 2,347545360,71017784,20.4,276527576,79.6,2013
The Conjuring,319494638,137400141,43.0,182094497,57.0,2013
A Good Day to Die Hard,304654182,67349198,22.1,237304984,77.9,2013
Oblivion,286168572,89107235,31.1,197061337,68.9,2013
Elysium,286140700,93050117,32.5,193090583,67.5,2013
Turbo,282570682,83028128,29.4,199542554,70.6,2013
Cloudy with a Chance of Meatballs 2,274325949,119793567,43.7,154532382,56.3,2013
Epic,268426634,107518682,40.1,160907952,59.9,2013
The Lone Ranger,260502115,89302115,34.3,171200000,65.7,2013
American Hustle,251171807,150117807,59.8,101054000,40.2,2013
Grown Ups 2,246984278,133668525,54.1,113315753,45.9,2013
After Earth,243611982,60522097,24.8,183089885,75.2,2013
Planes,239258712,90288712,37.7,148970000,62.3,2013
The Heat,229930771,159582188,69.4,70348583,30.6,2013
Hansel & Gretel: Witch Hunters,226349749,55703475,24.6,170646274,75.4,2013
Captain Phillips,218791811,107100855,49.0,111690956,51.0,2013
Journey to the West: Conquering the Demons,205637183,18058,0.0,205619125,100.0,2013
White House Down,205366737,73103784,35.6,132262953,64.4,2013
Percy Jackson: Sea of Monsters,199850315,68559554,34.3,131290761,65.7,2013
Jack the Giant Slayer,197687603,65187603,33.0,132500000,67.0,2013
The Secret Life of Walter Mitty,188133322,58236838,31.0,129896484,69.0,2013
12 Years a Slave,187733202,56671993,30.2,131061209,69.8,2013
The Butler,177313795,116632095,65.8,60681700,34.2,2013
Identity Thief,173965010,134506920,77.3,39458090,22.7,2013
Anchorman 2: The Legend Continues,171464676,125168368,73.0,46296308,27.0,2013
Olympus Has Fallen,170270201,98925640,58.1,71344561,41.9,2013
Insidious: Chapter 2,161919318,83586447,51.6,78332871,48.4,2013
Lone Survivor,154802912,125095601,80.8,29707311,19.2,2013
Jackass Presents: Bad Grandpa,151826547,102003019,67.2,49823528,32.8,2013
47 Ronin,151783839,38362475,25.3,113421364,74.7,2013
RED 2,148075565,53262560,36.0,94813005,64.0,2013
Mama,146428180,71628180,48.9,74800000,51.1,2013
Escape Plan,137328301,25135965,18.3,112192336,81.7,2013
2 Guns,131940411,75612460,57.3,56327951,42.7,2013
This Is the End,126041322,101470202,80.5,24571120,19.5,2013
Ender's Game,125544024,61737191,49.2,63806833,50.8,2013
Prisoners,122126687,61002302,50.0,61124385,50.0,2013
Jurassic Park 2013 Re0release,118192315,45385935,38.4,72806380,61.6,2013
Saving Mr. Banks,117867984,83301580,70.7,34566404,29.3,2013
Warm Bodies,116980662,66380662,56.7,50600000,43.3,2013
Personal Tailor,116126458,375892,0.3,115750566,99.7,2013
So Young,114926694,11186,0.0,114915508,100.0,2013
Free Birds,110387072,55750480,50.5,54636592,49.5,2013
Gangster Squad,105200903,46000903,43.7,59200000,56.3,2013
Instructions Not Included,100486616,44467206,44.3,56019410,55.7,2013
Philomena,100129872,37709979,37.7,62419893,62.3,2013
Blue Jasmine,99104804,33405481,33.7,65699323,66.3,2013
Young Detective Dee: Rise of the Sea Dragon,98774891,87783,0.0,98687108,99.9,2013
Riddick,98337295,42025135,42.7,56312160,57.3,2013
Safe Haven,97594140,71349120,73.1,26245020,26.9,2013
Evil Dead,97542952,54239856,55.6,43303096,44.4,2013
42,97470701,95020213,97.5,2450488,2.5,2013
The Mortal Instruments: City of Bones,95396573,31165421,32.7,64231152,67.3,2013
Rush,95224595,26947624,28.3,68276971,71.7,2013
Police Story: Lockdown,94249025,0,0.0,94249025,100.0,2013
The Internship,93492844,44672764,47.8,48820080,52.2,2013
The Purge,89328627,64473115,72.2,24855512,27.8,2013
Dhoom 3,88031955,8031955,9.1,80000000,90.9,2013
Pain & Gain,87305549,49875291,57.1,37430258,42.9,2013
About Time,87100449,15322921,17.6,71777528,82.4,2013
American Dreams in China,87097067,0,0.0,87097067,100.0,2013
Snowpiercer,86758912,4563650,5.3,82195262,94.7,2013
Carrie,84790678,35266619,41.6,49524059,58.4,2013
Finding Mr. Right,84112033,6945,0.0,84105088,100.0,2013
The Fighter Pilot,82879386,0,0.0,82879386,100.0,2013
Miracle in Cell No. 7,82101723,0,0.0,82101723,100.0,2013
The Attorney,78547586,557236,0.7,77990350,99.3,2013
The Family,78418811,36918811,47.1,41500000,52.9,2013
Scary Movie V,78378744,32015787,40.8,46362957,59.2,2013
R.I.P.D.,78324220,33618855,42.9,44705365,57.1,2013
Tiny Times,77717014,23462,0.0,77693552,100.0,2013
Suck Me Shakespeer,77676735,0,0.0,77676735,100.0,2013
The Book Thief,76586316,21488481,28.1,55097835,71.9,2013
Escape from Planet Earth,74597643,57012977,76.4,17584666,23.6,2013
August: Osage County,74188937,37738810,50.9,36450127,49.1,2013
The Best Man Holiday,72835710,70525195,96.8,2310515,3.2,2013
The Counselor,71009334,16973715,23.9,54035619,76.1,2013
Sole a catinelle,69903094,0,0.0,69903094,100.0,2013
The Call,68572631,51872378,75.6,16700253,24.4,2013
One Direction: This Is Us,68532898,28873374,42.1,39659524,57.9,2013
Stalingrad,68316452,1013945,1.5,67302507,98.5,2013
Thunder and the House of Magic,64197205,4091,0.0,64193114,100.0,2013
The Grandmaster,64076736,6594959,10.3,57481777,89.7,2013
Side Effects,63414135,32172757,50.7,31241378,49.3,2013
Runner Runner,62675095,19316646,30.8,43358449,69.2,2013
The Face Reader,61559184,515876,0.8,61043308,99.2,2013
The Legend of Hercules,61279452,18848538,30.8,42430914,69.2,2013
Kick0Ass 2,60795985,28795985,47.4,32000000,52.6,2013
A Haunted House,60159584,40041683,66.6,20117901,33.4,2013
Beautiful Creatures,60052138,19452138,32.4,40600000,67.6,2013
Snitch,57824674,42930462,74.2,14894212,25.8,2013
The Physician,57284237,0,0.0,57284237,100.0,2013
Firestorm,55754766,0,0.0,55754766,100.0,2013
Dallas Buyers Club,55198285,27298285,49.5,27900000,50.5,2013
A Madea Christmas,53396635,52543354,98.4,853281,1.6,2013
Temptation: Confessions of a Marriage Counselor,53143144,51975354,97.8,1167790,2.2,2013
Delivery Man,53120346,30664106,57.7,22456240,42.3,2013
The 100 Year0Old Man Who Climbed Out the Window and Disappeared,51167572,944193,1.8,50223379,98.2,2013
Dragon Ball Z: Battle of Gods,50461371,2553002,5.1,47908369,94.9,2013
The Berlin File,48972848,665210,1.4,48307638,98.6,2013
Homefront,48449416,20158898,41.6,28290518,58.4,2013
The Last Stand,48330757,12050299,24.9,36280458,75.1,2013
Her,48269269,25568251,53.0,22701018,47.0,2013
21 & Over,48065672,25682380,53.4,22383292,46.6,2013
Texas Chainsaw,47340586,34341945,72.5,12998641,27.5,2013
Tiny Times 2.0,47289937,43788,0.0,47246149,99.9,2013
Switch,47164301,0,0.0,47164301,100.0,2013
The Place Beyond the Pines,47052899,21403519,45.5,25649380,54.5,2013
Parker,46922566,17616641,37.5,29305925,62.5,2013
The Big Wedding,46522137,21819348,46.9,24702789,53.1,2013
Badges of Fury,46495296,0,0.0,46495296,100.0,2013
The World's End,46089287,26004851,56.4,20084436,43.6,2013
Grudge Match,44907260,29807260,66.4,15100000,33.6,2013
The White Storm,44670277,0,0.0,44670277,100.0,2013
Tarzan,44095996,0,0.0,44095996,100.0,2013
Secretly Greatly,43447199,0,0.0,43447199,100.0,2013
The Chef The Actor The Scoundrel,42970000,0,0.0,42970000,100.0,2013
Doraemon: Nobita's Secret Gadget Museum,42770271,0,0.0,42770271,100.0,2013
Jobs,42128352,16131410,38.3,25996942,61.7,2013
No Man's Land,41807712,0,0.0,41807712,100.0,2013
Lupin III vs. Detective Conan: The Movie,41397727,0,0.0,41397727,100.0,2013
Yolki 3,40267368,0,0.0,40267368,100.0,2013
Don Jon,39439355,24477704,62.1,14961651,37.9,2013
Antoine and Sebastian,38719881,0,0.0,38719881,100.0,2013
Cold Eyes,37795598,0,0.0,37795598,100.0,2013
Like Father Like Son,37170163,334616,0.9,36835547,99.1,2013
Detective Conan: Private Eye in the Distant Sea,36324232,0,0.0,36324232,100.0,2013
D√ºg√ºn Dernek,36185741,0,0.0,36185741,100.0,2013
The Terror Live,35659824,0,0.0,35659824,100.0,2013
Blind Detective,34958596,0,0.0,34958596,100.0,2013
Broken City,34737199,19701164,56.7,15036035,43.3,2013
Inside Llewyn Davis,32935319,13235319,40.2,19700000,59.8,2013
Serial Teachers,32849727,0,0.0,32849727,100.0,2013
Mud,32613173,21590086,66.2,11023087,33.8,2013
Midsummer's Equation,32514549,0,0.0,32514549,100.0,2013
Kevin Hart: Let Me Explain,32318051,32244051,99.8,74000,0.2,2013
Pok√©mon,32293377,0,0.0,32293377,100.0,2013
The After0Dinner Mysteries,32160741,0,0.0,32160741,100.0,2013
Underdogs,31775719,0,0.0,31775719,100.0,2013
Spring Breakers,31724284,14124284,44.5,17600000,55.5,2013
New World,31670607,457806,1.4,31212801,98.6,2013
101 Proposals,31283838,0,0.0,31283838,100.0,2013
A Wedding Invitation,30665036,14350,0.0,30650686,100.0,2013
Silent Witness,29315945,0,0.0,29315945,100.0,2013
Special ID,29139936,12666,0.0,29127270,100.0,2013
Kokow√§√§h 2,28811936,0,0.0,28811936,100.0,2013
The Suspect,28674130,218693,0.8,28455437,99.2,2013
The Four 2,28599970,0,0.0,28599970,100.0,2013
The Kiyosu Conference,28338665,0,0.0,28338665,100.0,2013
I Give It a Year,28328531,34657,0.1,28293874,99.9,2013
Mandela: Long Walk to Freedom,27985788,8323085,29.7,19662703,70.3,2013
Dark Skies,27858103,17418667,62.5,10439436,37.5,2013
Nebraska,27682872,17654912,63.8,10027960,36.2,2013
The Incredible Burt Wonderstone,27437881,22537881,82.1,4900000,17.9,2013
Gorko!,27369902,0,0.0,27369902,100.0,2013
Khumba,27187375,1029,0.0,27186346,100.0,2013
You're Next,26895481,18494006,68.8,8401475,31.2,2013
Mr. Go,26835201,0,0.0,26835201,100.0,2013
The Break Up Man,26477012,0,0.0,26477012,100.0,2013
The Way Way Back,26474920,21506546,81.2,4968374,18.8,2013
We Are the Nobles,26433651,0,0.0,26433651,100.0,2013
The Stolen Years,26249553,0,0.0,26249553,100.0,2013
One Night Surprise,26220159,0,0.0,26220159,100.0,2013
Platinum Data,26052718,0,0.0,26052718,100.0,2013
Gekijouban SPEC: Kur√¥zu 0 Zen no hen,25860404,0,0.0,25860404,100.0,2013
Unbeatable,25816154,0,0.0,25816154,100.0,2013
Man on the Edge,25774679,0,0.0,25774679,100.0,2013
Enough Said,25288872,17550872,69.4,7738000,30.6,2013
The Last Exorcism Part II,25051865,15179302,60.6,9872563,39.4,2013
Me Myself and Mum,24991467,0,0.0,24991467,100.0,2013
Drug War,24676341,128195,0.5,24548146,99.5,2013
The Tale of The Princess Kaguya,24479719,703232,2.9,23776487,97.1,2013
The Great Beauty,24395873,2852400,11.7,21543473,88.3,2013
Trance,24261569,2328743,9.6,21932826,90.4,2013
The Railway Man,24174885,4438438,18.4,19736447,81.6,2013
Out of Inferno,24109886,0,0.0,24109886,100.0,2013
Bring Happiness Home,23980000,0,0.0,23980000,100.0,2013
Transformers: Age of Extinction,1104054072,245439076,22.2,858614996,77.8,2014
The Hobbit: The Battle of the Five Armies,956019788,255119788,26.7,700900000,73.3,2014
Guardians of the Galaxy,772776600,333176600,43.1,439600000,56.9,2014
Maleficent,758410378,241410378,31.8,517000000,68.2,2014
The Hunger Games: Mockingjay 0 Part 1,755356711,337135885,44.6,418220826,55.4,2014
X0Men: Days of Future Past,746045700,233921534,31.4,512124166,68.6,2014
Captain America: The Winter Soldier,714421503,259766572,36.4,454654931,63.6,2014
Dawn of the Planet of the Apes,710644566,208545589,29.3,502098977,70.7,2014
The Amazing Spider0Man 2,708982323,202853933,28.6,506128390,71.4,2014
Interstellar,681070397,188020017,27.6,493050380,72.4,2014
Big Hero 6,657827828,222527828,33.8,435300000,66.2,2014
How to Train Your Dragon 2,621537519,177002924,28.5,444534595,71.5,2014
American Sniper,547626372,350126372,63.9,197500000,36.1,2014
Godzilla,524976069,200676069,38.2,324300000,61.8,2014
Rio 2,498781117,131538435,26.4,367242682,73.6,2014
Teenage Mutant Ninja Turtles,485004754,191204754,39.4,293800000,60.6,2014
The Lego Movie,468060692,257760692,55.1,210300000,44.9,2014
Lucy,458863600,126663600,27.6,332200000,72.4,2014
Penguins of Madagascar,373515621,83850911,22.4,289664710,77.6,2014
Edge of Tomorrow,370541256,100206256,27.0,270335000,73.0,2014
Gone Girl,369330363,167767189,45.4,201563174,54.6,2014
Night at the Museum: Secret of the Tomb,363204635,113746621,31.3,249458014,68.7,2014
Noah,359200044,101200044,28.2,258000000,71.8,2014
The Maze Runner,348319861,102427862,29.4,245891999,70.6,2014
300: Rise of an Empire,337580051,106580051,31.6,231000000,68.4,2014
22 Jump Street,331333876,191719337,57.9,139614539,42.1,2014
The Fault in Our Stars,307166834,124872350,40.7,182294484,59.3,2014
Divergent,288885818,150947895,52.3,137937923,47.7,2014
Paddington,282370135,76271832,27.0,206098303,73.0,2014
Mr. Peabody & Sherman,275698039,111506430,40.4,164191609,59.6,2014
Neighbors,270665134,150157400,55.5,120507734,44.5,2014
Exodus: Gods and Kings,268175631,65014513,24.2,203161118,75.8,2014
Annabelle,257047661,84273813,32.8,172773848,67.2,2014
Hercules,244819862,72688614,29.7,172131248,70.3,2014
RoboCop,242688965,58607007,24.1,184081958,75.9,2014
The Imitation Game,233555708,91125683,39.0,142430025,61.0,2014
Non0Stop,222809600,92168600,41.4,130641000,58.6,2014
Dracula Untold,217124280,56280355,25.9,160843925,74.1,2014
The Expendables 3,214657577,39322544,18.3,175335033,81.7,2014
Into the Woods,212902372,128002372,60.1,84900000,39.9,2014
Fury,211817906,85817906,40.5,126000000,59.5,2014
Need for Speed,203277636,43577636,21.4,159700000,78.6,2014
The Other Woman,196710396,83911193,42.7,112799203,57.3,2014
The Equalizer,192330738,101530738,52.8,90800000,47.2,2014
Breakup Buddies,189017596,777896,0.4,188239700,99.6,2014
Stand by Me Doraemon,183442714,0,0.0,183442714,100.0,2014
Serial Bad Weddings,176404493,0,0.0,176404493,100.0,2014
The Monkey King: Havoc in Heaven's Palace,175835580,0,0.0,175835580,100.0,2014
The Grand Budapest Hotel,172936941,59301324,34.3,113635617,65.7,2014
Dumb and Dumber To,169837010,86208010,50.8,83629000,49.2,2014
Into the Storm,161502194,47602194,29.5,113900000,70.5,2014
Unbroken,161459297,115637895,71.6,45821402,28.4,2014
The Monuments Men,155641650,78031620,50.1,77610030,49.9,2014
Ride Along,154468902,134938200,87.4,19530702,12.6,2014
Planes: Fire & Rescue,146965787,59165787,40.3,87800000,59.7,2014
The Taking of Tiger Mountain,141654055,228984,0.2,141425071,99.8,2014
The Admiral: Roaring Currents,138342258,2589811,1.9,135752447,98.1,2014
Let's Be Cops,138224951,82390774,59.6,55834177,40.4,2014
Annie,136853506,85911262,62.8,50942244,37.2,2014
Jack Ryan: Shadow Recruit,135503748,50577412,37.3,84926336,62.7,2014
Blended,127994610,46294610,36.2,81700000,63.8,2014
Sex Tape,126069509,38543473,30.6,87526036,69.4,2014
The Theory of Everything,123726688,35893537,29.0,87833151,71.0,2014
The Nut Job,120885527,64251541,53.2,56633986,46.8,2014
Pompeii,117831631,23219748,19.7,94611883,80.3,2014
Seventh Son,114178613,17223265,15.1,96955348,84.9,2014
The Purge: Anarchy,111928365,71962800,64.3,39965565,35.7,2014
Dad Where Are We Going?,111870000,0,0.0,111870000,100.0,2014
The Boxtrolls,108255770,50837305,47.0,57418465,53.0,2014
Horrible Bosses 2,107645357,54445357,50.6,53200000,49.4,2014
The Breakup Guru,106980263,208959,0.2,106771304,99.8,2014
Ouija,103590271,50856010,49.1,52734261,50.9,2014
Birdman or (The Unexpected Virtue of Ignorance),103215094,42340598,41.0,60874496,59.0,2014
Transcendence,103039258,23022309,22.3,80016949,77.7,2014
Heaven Is for Real,101888019,91443253,89.7,10444766,10.3,2014
Alexander and the Terrible Horrible No Good Very Bad Day,100654149,66954149,66.5,33700000,33.5,2014
Tammy,100375432,84525432,84.2,15850000,15.8,2014
PK,100370104,10616104,10.6,89754000,89.4,2014
The Continent,100125957,0,0.0,100125957,100.0,2014
The Book of Life,99783556,50151543,50.3,49632013,49.7,2014
Ode to My Father,99085291,2300121,2.3,96785170,97.7,2014
Fleet of Time,94244191,569280,0.6,93674911,99.4,2014
The Man from Macau,93864936,0,0.0,93864936,100.0,2014
Paranormal Activity: The Marked Ones,90894962,32462372,35.7,58432590,64.3,2014
The Hundred0Foot Journey,89514453,54240821,60.6,35273632,39.4,2014
Deliver Us from Evil,87937815,30577122,34.8,57360693,65.2,2014
A Million Ways to Die in the West,87189756,43139300,49.5,44050456,50.5,2014
Step Up All In,86165646,14904384,17.3,71261262,82.7,2014
John Wick,86013056,43037835,50.0,42975221,50.0,2014
The Judge,84419388,47119388,55.8,37300000,44.2,2014
Tiny Times 3.0,82320000,0,0.0,82320000,100.0,2014
Gone with the Bullets,81387479,0,0.0,81387479,100.0,2014
Muppets Most Wanted,80383113,51183113,63.7,29200000,36.3,2014
Spanish Affair,78768613,0,0.0,78768613,100.0,2014
If I Stay,78274843,50474843,64.5,27800000,35.5,2014
Head Full of Honey,78127384,0,0.0,78127384,100.0,2014
I Frankenstein,76801179,19075290,24.8,57725889,75.2,2014
Crimson Peak,74679822,31090320,41.6,43589502,58.4,2014
My Old Classmate,73052128,0,0.0,73052128,100.0,2014
The B√©lier Family,72751538,0,0.0,72751538,100.0,2014
Brick Mansions,71416730,20396829,28.6,51019901,71.4,2014
Son of God,70829270,59700064,84.3,11129206,15.7,2014
Think Like a Man Too,70181428,65182182,92.9,4999246,7.1,2014
Jersey Boys,67647013,47047013,69.5,20600000,30.5,2014
The Giver,66980456,45090374,67.3,21890082,32.7,2014
Selma,66787908,52076908,78.0,14711000,22.0,2014
Beijing Love Story,65842375,428318,0.7,65414057,99.3,2014
The House That Never Dies,65220000,0,0.0,65220000,100.0,2014
The Pirates,64858224,415775,0.6,64442449,99.4,2014
God's Not Dead,64667874,60755732,94.0,3912142,6.0,2014
The Pirate Fairy,63998725,0,0.0,63998725,100.0,2014
The Inbetweeners 2,63852235,0,0.0,63852235,100.0,2014
Begin Again,63464861,16170632,25.5,47294229,74.5,2014
The White Haired Witch of Lunar Kingdom,62515046,0,0.0,62515046,100.0,2014
The Walk,61181942,10137502,16.6,51044440,83.4,2014
Miss Granny,58940254,0,0.0,58940254,100.0,2014
A Walk Among the Tombstones,58834384,26307600,44.7,32526784,55.3,2014
Dolphin Tale 2,57824533,42024533,72.7,15800000,27.3,2014
St. Vincent,54837234,44137712,80.5,10699522,19.5,2014
No Good Deed,54323210,52543632,96.7,1779578,3.3,2014
Overheard 3,53493428,0,0.0,53493428,100.0,2014
Supercondriaque,53425036,0,0.0,53425036,100.0,2014
3 Days to Kill,53260230,30697999,57.6,22562231,42.4,2014
Rurouni Kenshin Part II: Kyoto Inferno,52696176,0,0.0,52696176,100.0,2014
Wild,52501541,37880356,72.2,14621185,27.8,2014
Magic in the Moonlight,51029361,10539326,20.7,40490035,79.3,2014
About Last Night,50445860,48637684,96.4,1808176,3.6,2014
Dearest 2014 Re0release,50000583,0,0.0,50000583,100.0,2014
Whiplash,48982041,13092000,26.7,35890041,73.3,2014
Chef,48428048,31424003,64.9,17004045,35.1,2014
Boyhood,48137666,25352281,52.7,22785385,47.3,2014
Coming Home,47587984,377607,0.8,47210377,99.2,2014
Beauty and the Beast,47430624,0,0.0,47430624,100.0,2014
Nightcrawler,47425835,32381217,68.3,15044618,31.7,2014
Earth to Echo,45681062,38934842,85.2,6746220,14.8,2014
That Awkward Moment,45640143,26068955,57.1,19571188,42.9,2014
Love on the Cloud,45386560,271734,0.6,45114826,99.4,2014
Oculus,44446287,27695246,62.3,16751041,37.7,2014
The Great Hypnotist,44077818,0,0.0,44077818,100.0,2014
Kick,43996483,2472695,5.6,41523788,94.4,2014
Asterix and Obelix: Mansion of the Gods,42830578,0,0.0,42830578,100.0,2014
Thermae Romae II,42473163,0,0.0,42473163,100.0,2014
Bang Bang,42045981,2546172,6.1,39499809,93.9,2014
Detective Conan: The Sniper from Another Dimension,42028116,0,0.0,42028116,100.0,2014
Rurouni Kenshin: The Legend Ends,41900000,0,0.0,41900000,100.0,2014
As Above So Below,41898409,21321100,50.9,20577309,49.1,2014
This Is Where I Leave You,41296320,34296320,83.0,7000000,17.0,2014
Boonie Bears: To the Rescue,40163675,0,0.0,40163675,100.0,2014
The November Man,39661919,25018119,63.1,14643800,36.9,2014
Recep Ivedik 4,39477906,0,0.0,39477906,100.0,2014
Sin City: A Dame to Kill For,39407616,13757804,34.9,25649812,65.1,2014
The Gambler,39280992,33680992,85.7,5600000,14.3,2014
Samba,39178695,151530,0.4,39027165,99.6,2014
Women Who Flirt,39156132,375495,1.0,38780637,99.0,2014
Forbidden Empire 2014 Re0release,38885962,0,0.0,38885962,100.0,2014
The Best of Me,38609668,26766213,69.3,11843455,30.7,2014
Million Dollar Arm,38483455,36457627,94.7,2025828,5.3,2014
But Always,38039248,430760,1.1,37608488,98.9,2014
Devil's Due,36921560,15821461,42.9,21100099,57.1,2014
A Most Wanted Man,36233517,17237855,47.6,18995662,52.4,2014
Kundo: Age of the Rampant,35941291,280958,0.8,35660333,99.2,2014
Doraemon the Movie: The New Records of Nobita's Spaceblazer 2014 Re0release,35861856,0,0.0,35861856,100.0,2014
The Water Diviner,35396641,4196641,11.9,31200000,88.1,2014
When Marnie Was There,34949567,561085,1.6,34388482,98.4,2014
Endless Love,34718173,23438250,67.5,11279923,32.5,2014
Black & White: The Dawn of Justice,34146896,0,0.0,34146896,100.0,2014
My Love Don't Cross That River,34012261,0,0.0,34012261,100.0,2014
Don't Go Breaking My Heart 2,33801759,0,0.0,33801759,100.0,2014
Get on Up,33448971,30703100,91.8,2745871,8.2,2014
Girls,33325338,0,0.0,33325338,100.0,2014
The Crossing,32806475,0,0.0,32806475,100.0,2014
Old Boys: The Way of the Dragon,32800000,0,0.0,32800000,100.0,2014
Tinker Bell and the Legend of the NeverBeast,31836701,0,0.0,31836701,100.0,2014
The Four 3,31521335,0,0.0,31521335,100.0,2014
Wild Tales,31478893,3106530,9.9,28372363,90.1,2014
Tazza: The Hidden Card,31278476,251555,0.8,31026921,99.2,2014
Mrs. Brown's Boys D'Movie,31116264,0,0.0,31116264,100.0,2014
Rise of the Legend,30932534,0,0.0,30932534,100.0,2014
Winter's Tale,30800231,12600231,40.9,18200000,59.1,2014
When the Game Stands Tall,30138754,30127963,100.0,10791,0.0,2014
Draft Day,29824199,28842237,96.7,981962,3.3,2014
Big Eyes,29253166,14482031,49.5,14771135,50.5,2014
The Fatal Encounter,29060186,0,0.0,29060186,100.0,2014
Maya the Bee Movie,28638603,0,0.0,28638603,100.0,2014
Pok√©mon the Movie: Diancie and the Cocoon of Destruction,28595105,0,0.0,28595105,100.0,2014
The Divine Move,27926871,136707,0.5,27790164,99.5,2014
Nicholas on Holiday,27567832,0,0.0,27567832,100.0,2014
Grace of Monaco,27515247,0,0.0,27515247,100.0,2014
Left Behind,27405896,14019924,51.2,13385972,48.8,2014
Joy of Fatherhood,27088817,0,0.0,27088817,100.0,2014
A Hard Day,26488847,19004,0.0,26469843,99.9,2014
Top Five,26117471,25317471,96.9,800000,3.1,2014
Iceman,26033917,7679,0.0,26026238,100.0,2014
Meet Miss Anxiety,25948636,0,0.0,25948636,100.0,2014
Love Rosie,25574387,20431,0.0,25553956,99.9,2014
A Haunted House 2,25358716,17329486,68.3,8029230,31.7,2014
And So It Goes,25312387,15160801,59.9,10151586,40.1,2014
Kung Fu Jungle,24070765,129784,0.5,23940981,99.5,2014
Hot Road,22916313,0,0.0,22916313,100.0,2014
Fading Gigolo,22706304,3769873,16.6,18936431,83.4,2014
Star Wars: Episode VII 0 The Force Awakens,2068223624,936662225,45.3,1131561399,54.7,2015
Jurassic World,1670400637,652270625,39.0,1018130012,61.0,2015
Furious 7,1515047671,353007020,23.3,1162040651,76.7,2015
Avengers: Age of Ultron,1402805868,459005868,32.7,943800000,67.3,2015
Minions,1159398397,336045770,29.0,823352627,71.0,2015
Spectre,880674609,200074609,22.7,680600000,77.3,2015
Inside Out,858294430,356461711,41.5,501832719,58.5,2015
Mission: Impossible 0 Rogue Nation,682714267,195042377,28.6,487671890,71.4,2015
The Hunger Games: Mockingjay 0 Part 2,653428261,281723902,43.1,371704359,56.9,2015
The Martian,630161890,228433663,36.2,401728227,63.8,2015
Fifty Shades of Grey,569651467,166167230,29.2,403484237,70.8,2015
Cinderella,542351353,201151353,37.1,341200000,62.9,2015
The Revenant,532950503,183637894,34.5,349312609,65.5,2015
Ant0Man,519311965,180202163,34.7,339109802,65.3,2015
Hotel Transylvania 2,474800000,169700110,35.7,305099890,64.3,2015
San Andreas,474590832,155190832,32.7,319400000,67.3,2015
Terminator Genisys,440603537,89760956,20.4,350842581,79.6,2015
Kingsman: The Secret Service,414351546,128261724,31.0,286089822,69.0,2015
Monster Hunt,387053506,32766,0.0,387020740,100.0,2015
Home,386041607,177397510,46.0,208644097,54.0,2015
Mad Max: Fury Road,379436354,153636354,40.5,225800000,59.5,2015
The Good Dinosaur,332207671,123087120,37.1,209120551,62.9,2015
Taken 3,326479141,89256424,27.3,237222717,72.7,2015
The SpongeBob Movie: Sponge Out of Water,325186032,162994032,50.1,162192000,49.9,2015
Maze Runner: The Scorch Trials,312296056,81697192,26.2,230598864,73.8,2015
The Divergent Series: Insurgent,297002527,130179072,43.8,166823455,56.2,2015
Pitch Perfect 2,287144079,184296230,64.2,102847849,35.8,2015
Mojin: The Lost Legend,259368448,1243810,0.5,258124638,99.5,2015
Lost in Hong Kong,256283912,1302281,0.5,254981631,99.5,2015
The Peanuts Movie,246233113,130178411,52.9,116054702,47.1,2015
Pixels,244874809,78747585,32.2,166127224,67.8,2015
Daddy's Home,242786137,150357137,61.9,92429000,38.1,2015
Spy,235666219,110825712,47.0,124840507,53.0,2015
Alvin and the Chipmunks: The Road Chip,234798636,85886987,36.6,148911649,63.4,2015
Goodbye Mr. Loser,228122928,1293626,0.6,226829302,99.4,2015
Ted 2,215863606,81476385,37.7,134387221,62.3,2015
Tomorrowland,209035668,93436322,44.7,115599346,55.3,2015
Everest,203427584,43482270,21.4,159945314,78.6,2015
Straight Outta Compton,201634991,161197785,79.9,40437206,20.1,2015
The Intern,194764672,75764672,38.9,119000000,61.1,2015
Jian Bing Man,186683536,0,0.0,186683536,100.0,2015
Jupiter Ascending,184287723,47387723,25.7,136900000,74.3,2015
Creed,174167581,109767581,63.0,64400000,37.0,2015
Bridge of Spies,165478348,72313754,43.7,93164594,56.3,2015
From Vegas to Macau II,163877532,0,0.0,163877532,100.0,2015
Focus,159162963,53862963,33.8,105300000,66.2,2015
Goosebumps,158260952,80080379,50.6,78180573,49.4,2015
Ip Man 3,156954938,2679437,1.7,154275501,98.3,2015
The Hateful Eight,155760117,54117416,34.7,101642701,65.3,2015
Monkey King: Hero Is Back,153262397,0,0.0,153262397,100.0,2015
Gods of Egypt,150680864,31153464,20.7,119527400,79.3,2015
The Last Witch Hunter,146936910,27367660,18.6,119569250,81.4,2015
Trainwreck,140795793,110212700,78.3,30583093,21.7,2015
Mr. Six,139191345,1415450,1.0,137775895,99.0,2015
Point Break,133782481,28782481,21.5,105000000,78.5,2015
The Big Short,133440870,70259870,52.7,63181000,47.3,2015
Pan,128988320,35088320,27.2,93900000,72.8,2015
Detective Chinatown,125842935,474252,0.4,125368683,99.6,2015
Wolf Totem,125837070,210591,0.2,125626479,99.8,2015
Ride Along 2,124605297,91221830,73.2,33383467,26.8,2015
Magic Mike XXL,122613057,66013057,53.8,56600000,46.2,2015
Dragon Blade,122593849,74068,0.0,122519781,99.9,2015
Insidious: Chapter 3,112983889,52218558,46.2,60765331,53.8,2015
Get Hard,111811453,90411453,80.9,21400000,19.1,2015
The Man from U.N.C.L.E.,110045109,45445109,41.3,64600000,58.7,2015
The 5th Wave,109906372,34916787,31.8,74989585,68.2,2015
Paul Blart: Mall Cop 2,107588225,71038190,66.0,36550035,34.0,2015
Vacation,107228221,58884188,54.9,48344033,45.1,2015
Chronicles of the Ghostly Tribe,106380000,0,0.0,106380000,100.0,2015
Shaun the Sheep Movie,106209378,19375982,18.2,86833396,81.8,2015
Sisters,105011053,87044645,82.9,17966408,17.1,2015
Chappie,102811889,31569268,30.7,71242621,69.3,2015
Joy,101134059,56451232,55.8,44682827,44.2,2015
Black Mass,99975678,62575678,62.6,37400000,37.4,2015
Spotlight,98690254,45055776,45.7,53634478,54.3,2015
Devil and Angel,98599942,131058,0.1,98468884,99.9,2015
The Visit,98450062,65206105,66.2,33243957,33.8,2015
The Little Prince,97571250,1339152,1.4,96232098,98.6,2015
Assassination,96119773,1904682,2.0,94215091,98.0,2015
Poltergeist,95437994,47425125,49.7,48012869,50.3,2015
Veteran,94393020,1200627,1.3,93192393,98.7,2015
In the Heart of the Sea,94320758,25020758,26.5,69300000,73.5,2015
Kill Zone 2,93638358,11998,0.0,93626360,100.0,2015
Southpaw,91970827,52421953,57.0,39548874,43.0,2015
The Second Best Exotic Marigold Hotel,85978266,33078266,38.5,52900000,61.5,2015
Paper Towns,85512300,32000304,37.4,53511996,62.6,2015
Sicario,84872444,46889293,55.2,37983151,44.8,2015
Our Times,83867493,0,0.0,83867493,100.0,2015
Suck Me Shakespeer 2,83027924,0,0.0,83027924,100.0,2015
Hitman: Agent 47,82347656,22467450,27.3,59880206,72.7,2015
Wolf Warrior,81411331,0,0.0,81411331,100.0,2015
Go Away Mr. Tumor,80606893,286639,0.4,80320254,99.6,2015
The Wedding Ringer,79799880,64460211,80.8,15339669,19.2,2015
Paranormal Activity: The Ghost Dimension,78903124,18300124,23.2,60603000,76.8,2015
The Left Ear,78015473,0,0.0,78015473,100.0,2015
Tiny Times 4.0,77750000,0,0.0,77750000,100.0,2015
Bajrangi Bhaijaan,75547184,8178001,10.8,67369183,89.2,2015
War Room,73267874,67790117,92.5,5477757,7.5,2015
The Transporter Refueled,72629670,16029670,22.1,56600000,77.9,2015
Run All Night,71661644,26461644,36.9,45200000,63.1,2015
13 Hours: The Secret Soldiers of Benghazi,69411370,52853219,76.1,16558151,23.9,2015
Running Man,68782475,310978,0.5,68471497,99.5,2015
A Violent Prosecutor,66736633,0,0.0,66736633,100.0,2015
The Age of Adaline,65663276,42629776,64.9,23033500,35.1,2015
Monk Comes Down the Mountain,64455686,0,0.0,64455686,100.0,2015
Zhongkui: Snow Girl and the Dark Crystal,64325947,165428,0.3,64160519,99.7,2015
The Danish Girl,64191523,11114018,17.3,53077505,82.7,2015
The Boy,64188367,35819556,55.8,28368811,44.2,2015
The Hundred Regiments Offensive,63230000,0,0.0,63230000,100.0,2015
The Longest Ride,62944815,37446117,59.5,25498698,40.5,2015
Unfriended,62882090,32482090,51.7,30400000,48.3,2015
Brooklyn,62076141,38322743,61.7,23753398,38.3,2015
Dragon Ball Z: Resurrection 'F',61768190,8008363,13.0,53759827,87.0,2015
Woman in Gold,61619773,33307793,54.1,28311980,45.9,2015
Krampus,61548707,42725475,69.4,18823232,30.6,2015
The Perfect Guy,60273173,57027435,94.6,3245738,5.4,2015
Forever Young,59981902,149761,0.2,59832141,99.8,2015
No Escape,54418872,27288872,50.1,27130000,49.9,2015
Sinister 2,53329150,27740955,52.0,25588195,48.0,2015
Detective Conan: Sunflowers of Inferno,52920296,0,0.0,52920296,100.0,2015
Prem Ratan Dhan Payo,52715771,4364639,8.3,48351132,91.7,2015
The Boy Next Door,52425855,35423380,67.6,17002475,32.4,2015
The Night Before,52395996,43047372,82.2,9348624,17.8,2015
Hollywood Adventures,52265070,0,0.0,52265070,100.0,2015
Yo0kai Watch Movie: It's the Secret of Birth Meow!,51838845,257343,0.5,51581502,99.5,2015
Hot Pursuit,51680201,34580201,66.9,17100000,33.1,2015
The Himalayas,50544493,696717,1.4,49847776,98.6,2015
The Boy and the Beast,49714378,490643,1.0,49223735,99.0,2015
Surprise,49567466,0,0.0,49567466,100.0,2015
Entourage,49263404,32363404,65.7,16900000,34.3,2015
The Woman in Black 2: Angel of Death,48854305,26501323,54.2,22352982,45.8,2015
Concussion,48623572,34542474,71.0,14081098,29.0,2015
Inside Men,47616503,0,0.0,47616503,100.0,2015
The Dead End,47600000,0,0.0,47600000,100.0,2015
Boonie Bears: A Mystical Winter,47581416,0,0.0,47581416,100.0,2015
Mortdecai,47275695,7696134,16.3,39579561,83.7,2015
Let's Get Married,45972724,462918,1.0,45509806,99.0,2015
Somewhere Only We Know,45737711,482341,1.1,45255370,98.9,2015
McFarland USA,45710059,44482410,97.3,1227649,2.7,2015
Still Alice,44779195,18754371,41.9,26024824,58.1,2015
Max,43956255,42656255,97.0,1300000,3.0,2015
The DUFF,43709744,34030343,77.9,9679401,22.1,2015
Legend,42972994,1872994,4.4,41100000,95.6,2015
The Gallows,42964410,22764410,53.0,20200000,47.0,2015
Love the Coopers,42426912,26302731,62.0,16124181,38.0,2015
The Throne,42165755,0,0.0,42165755,100.0,2015
The Lady in the Van,41387687,10021175,24.2,31366512,75.8,2015
Ricki and the Flash,41325328,26822144,64.9,14503184,35.1,2015
Spanish Affair 2,40591862,0,0.0,40591862,100.0,2015
Carol,40272135,12711491,31.6,27560644,68.4,2015
Northern Limit Line,40034677,337907,0.8,39696770,99.2,2015
Ex0Files 2: The Backup Strikes Back,39108291,0,0.0,39108291,100.0,2015
Criminal,38803993,14708696,37.9,24095297,62.1,2015
Boruto: Naruto the Movie,38362448,919651,2.4,37442797,97.6,2015
The Lazarus Effect,38356892,25801570,67.3,12555322,32.7,2015
Helios,37938005,0,0.0,37938005,100.0,2015
A Walk in the Woods,37461274,29504281,78.8,7956993,21.2,2015
Ex Machina,36869414,25442958,69.0,11426456,31.0,2015
Burnt,36606743,13651946,37.3,22954797,62.7,2015
The Priests,36577134,185093,0.5,36392041,99.5,2015
The New Adventures of Aladdin,35771820,0,0.0,35771820,100.0,2015
Heidi,35755670,0,0.0,35755670,100.0,2015
Room,35401758,14677654,41.5,20724104,58.5,2015
Lost and Love,34930177,188817,0.5,34741360,99.5,2015
Secret in Their Eyes,34854990,20180155,57.9,14674835,42.1,2015
Dad Where Are We Going 2,34840000,0,0.0,34840000,100.0,2015
Doraemon: Nobita no Uch√ª Eiy√ªki,34811747,0,0.0,34811747,100.0,2015
Steve Jobs,34441873,17766658,51.6,16675215,48.4,2015
Victor Frankenstein,34227298,5775076,16.9,28452222,83.1,2015
The Witness,33963557,418063,1.2,33545494,98.8,2015
Project Almanac,33213241,22348241,67.3,10865000,32.7,2015
Dilwale,31994323,4871263,15.2,27123060,84.8,2015
Suffragette,31972096,4702420,14.7,27269676,85.3,2015
Self/less,31807156,12279691,38.6,19527465,61.4,2015
Saving Mr. Wu,31222161,92696,0.3,31129465,99.7,2015
Attack on Titan Part 1,30810658,449523,1.5,30361135,98.5,2015
A Man Called Ove,30692889,3479315,11.3,27213574,88.7,2015
Far from the Madding Crowd,30229977,12236500,40.5,17993477,59.5,2015
Mr. Holmes,29355203,17737646,60.4,11617557,39.6,2015
Love & Mercy,28641776,12551031,43.8,16090745,56.2,2015
Flying Colors,28525563,0,0.0,28525563,100.0,2015
Triumph in the Skies,28085162,0,0.0,28085162,100.0,2015
The 33,27972023,12227722,43.7,15744301,56.3,2015
Irrational Man,27391084,4030360,14.7,23360724,85.3,2015
Detective K: Secret of the Lost Island,27387870,185367,0.7,27202503,99.3,2015
To the Fore,27267799,0,0.0,27267799,100.0,2015
American Ultra,27262374,14440985,53.0,12821389,47.0,2015
Orange,26261536,0,0.0,26261536,100.0,2015
Aloha,26250020,21067116,80.3,5182904,19.7,2015
Huevos: Little Rooster's Egg0cellent Adventure,25892561,9080818,35.1,16811743,64.9,2015
D√ºg√ºn Dernek 2: S√ºnnet,25836668,0,0.0,25836668,100.0,2015
Look Who's Back,25513752,0,0.0,25513752,100.0,2015
Serial Teachers 2,25364150,0,0.0,25364150,100.0,2015
Wild City,24817852,34866,0.1,24782986,99.9,2015
Captain America: Civil War,1153296293,408084349,35.4,745211944,64.6,2016
Rogue One: A Star Wars Story,1056057273,532177324,50.4,523879949,49.6,2016
Finding Dory,1028570889,486295561,47.3,542275328,52.7,2016
Zootopia,1023784195,341268248,33.3,682515947,66.7,2016
The Jungle Book,966550600,364001123,37.7,602549477,62.3,2016
The Secret Life of Pets,875697467,368623860,42.1,507073607,57.9,2016
Batman v Superman: Dawn of Justice,874360194,330360194,37.8,544000000,62.2,2016
Fantastic Beasts and Where to Find Them,816037575,234037575,28.7,582000000,71.3,2016
Deadpool,782612155,363070709,46.4,419541446,53.6,2016
Suicide Squad,749200054,325100054,43.4,424100000,56.6,2016
Doctor Strange,677718395,232641920,34.3,445076475,65.7,2016
Moana,643331111,248757044,38.7,394574067,61.3,2016
Sing,634151679,270395425,42.6,363756254,57.4,2016
The Mermaid,553810228,3232685,0.6,550577543,99.4,2016
X0Men: Apocalypse,543934105,155442489,28.6,388491616,71.4,2016
Kung Fu Panda 3,521170825,143528619,27.5,377642206,72.5,2016
La La Land,447407695,151101803,33.8,296305892,66.2,2016
Warcraft,439048914,47365290,10.8,391683624,89.2,2016
Jason Bourne,415484914,162434410,39.1,253050504,60.9,2016
Ice Age: Collision Course,408579038,64063008,15.7,344516030,84.3,2016
Independence Day: Resurgence,389681935,103144286,26.5,286537649,73.5,2016
Your Name.,357986087,5017246,1.4,352968841,98.6,2016
The Legend of Tarzan,357243061,126643061,35.5,230600000,64.5,2016
The Angry Birds Movie,352333929,107509366,30.5,244824563,69.5,2016
Trolls,347013487,153856089,44.3,193157398,55.7,2016
Star Trek Beyond,343471816,158848340,46.2,184623476,53.8,2016
The Great Wall,334933831,45540830,13.6,289393001,86.4,2016
Now You See Me 2,334897606,65075540,19.4,269822066,80.6,2016
The Conjuring 2,321370008,102470008,31.9,218900000,68.1,2016
Resident Evil: The Final Chapter,312242626,26830068,8.6,285412558,91.4,2016
Dangal,303723636,12391761,4.1,291331875,95.9,2016
Passengers,303144152,100014699,33.0,203129453,67.0,2016
Alice Through the Looking Glass,299457024,77041381,25.7,222415643,74.3,2016
Miss Peregrine's Home for Peculiar Children,296482446,87242834,29.4,209239612,70.6,2016
Teenage Mutant Ninja Turtles: Out of the Shadows,245623848,82051601,33.4,163572247,66.6,2016
Sully,243870033,125070033,51.3,118800000,48.7,2016
Assassin's Creed,240697856,54647948,22.7,186049908,77.3,2016
Hidden Figures,235956898,169607287,71.9,66349611,28.1,2016
Ghostbusters,229147509,128350574,56.0,100796935,44.0,2016
Inferno,220021259,34343574,15.6,185677685,84.4,2016
Central Intelligence,216940871,127440871,58.7,89500000,41.3,2016
Bridget Jones's Baby,211952420,24252420,11.4,187700000,88.6,2016
Me Before You,208445075,56245075,27.0,152200000,73.0,2016
London Has Fallen,205754447,62524260,30.4,143230187,69.6,2016
Arrival,203388186,100546139,49.4,102842047,50.6,2016
The BFG,195243411,55483770,28.4,139759641,71.6,2016
The Monkey King 2,193678298,709982,0.4,192968316,99.6,2016
Bad Moms,183936074,113257297,61.6,70678777,38.4,2016
Storks,183679278,72679278,39.6,111000000,60.4,2016
From Vegas to Macau III,181732879,0,0.0,181732879,100.0,2016
Hacksaw Ridge,180563636,67209615,37.2,113354021,62.8,2016
Allegiant,179246868,66184051,36.9,113062817,63.1,2016
Operation Mekong,173839072,800012,0.5,173039060,99.5,2016
The Girl on the Train,173185859,75395035,43.5,97790824,56.5,2016
The Huntsman: Winter's War,164989338,48390190,29.3,116599148,70.7,2016
The Magnificent Seven,162360636,93432655,57.5,68927981,42.5,2016
Jack Reacher: Never Go Back,162146076,58697076,36.2,103449000,63.8,2016
Don't Breathe,157761002,89217875,56.6,68543127,43.4,2016
The Accountant,155560045,86260045,55.5,69300000,44.5,2016
Lights Out,149368835,67268835,45.0,82100000,55.0,2016
Time Raiders,145819137,0,0.0,145819137,100.0,2016
Pete's Dragon,143695338,76233151,53.1,67462187,46.9,2016
Sausage Party,140705322,97685686,69.4,43019636,30.6,2016
Lion,140312928,51738905,36.9,88574023,63.1,2016
Skiptrace,136579287,0,0.0,136579287,100.0,2016
Mechanic: Resurrection,125729635,21218403,16.9,104511232,83.1,2016
Deepwater Horizon,121790373,61433527,50.4,60356846,49.6,2016
Allied,119520023,40098064,33.5,79421959,66.5,2016
I Belonged to You,119107580,744541,0.6,118363039,99.4,2016
The Shallows,119100758,55124043,46.3,63976715,53.7,2016
The Purge: Election Year,118587880,79213375,66.8,39374505,33.2,2016
Why Him?,118102725,60323786,51.1,57778939,48.9,2016
Book of Love,114679097,0,0.0,114679097,100.0,2016
Office Christmas Party,114501299,54767494,47.8,59733805,52.2,2016
How to Be Single,112543513,46843513,41.6,65700000,58.4,2016
10 Cloverfield Lane,110216998,72082998,65.4,38134000,34.6,2016
Neighbors 2: Sorority Rising,108007109,55455765,51.3,52551344,48.7,2016
Cold War 2,103197501,560824,0.5,102636677,99.5,2016
Railroad Tigers,102205175,218044,0.2,101987131,99.8,2016
Some Like It Hot,95721752,100026,0.1,95621726,99.9,2016
Dirty Grandpa,94073028,35593113,37.8,58479915,62.2,2016
Ben0Hur,94061311,26410477,28.1,67650834,71.9,2016
Money Monster,93282604,41012075,44.0,52270529,56.0,2016
Train to Busan,92742323,2129768,2.3,90612555,97.7,2016
My Big Fat Greek Wedding 2,90632641,59689605,65.9,30943036,34.1,2016
Collateral Beauty,88616021,31016021,35.0,57600000,65.0,2016
Line Walker,88228755,0,0.0,88228755,100.0,2016
Sultan,87280000,6200000,7.1,81080000,92.9,2016
War Dogs,86434523,43034523,49.8,43400000,50.2,2016
Big Fish & Begonia,85409373,0,0.0,85409373,100.0,2016
Nerve,85251425,38583626,45.3,46667799,54.7,2016
Leap!,84197417,2844490,3.4,81352927,96.6,2016
Ouija: Origin of Evil,81705746,35144505,43.0,46561241,57.0,2016
Underworld: Blood Wars,81093313,30353973,37.4,50739340,62.6,2016
Manchester by the Sea,78988148,47695371,60.4,31292777,39.6,2016
The Boss,78844582,63285885,80.3,15558697,19.7,2016
Shin Godzilla,77947607,1918403,2.5,76029204,97.5,2016
Mike and Dave Need Wedding Dates,77068246,46009673,59.7,31058573,40.3,2016
Kubo and the Two Strings,76249438,48023088,63.0,28226350,37.0,2016
Quo vado?,75878701,0,0.0,75878701,100.0,2016
Boo! A Madea Halloween,74827344,73206343,97.8,1621001,2.2,2016
Miracles from Heaven,73983003,61705123,83.4,12277880,16.6,2016
The Nice Guys,71261763,36261763,50.9,35000000,49.1,2016
I Am Not Madame Bovary,70826207,436798,0.6,70389409,99.4,2016
See You Tomorrow,70065569,0,0.0,70065569,100.0,2016
One Piece Film: Gold,66207073,423593,0.6,65783480,99.4,2016
Moonlight,65172611,27854932,42.7,37317679,57.3,2016
Monster Trucks,64493915,33370166,51.7,31123749,48.3,2016
Fences,64414761,57682904,89.5,6731857,10.5,2016
Hail Caesar!,63647656,30498085,47.9,33149571,52.1,2016
Huo guo ying xiong,58106427,779818,1.3,57326609,98.7,2016
L.O.R.D: Legend of Ravaging Dynasties,58089494,350456,0.6,57739038,99.4,2016
Nine Lives,57814445,19700032,34.1,38114413,65.9,2016
Zoolander 2,56722693,28848693,50.9,27874000,49.1,2016
Barbershop: The Next Cut,55630051,54030051,97.1,1600000,2.9,2016
The Age of Shadows,54491162,541719,1.0,53949443,99.0,2016
A Chinese Odyssey: Part Three,53306108,0,0.0,53306108,100.0,2016
Tunnel,52444295,568876,1.1,51875419,98.9,2016
Patriots Day,52185751,31886361,61.1,20299390,38.9,2016
My Beloved Bodyguard,52165873,0,0.0,52165873,100.0,2016
The Finest Hours,52099090,27569558,52.9,24529532,47.1,2016
Master,51636415,597251,1.2,51039164,98.8,2016
Doraemon the Movie: Nobita and the Birth of Japan,50939840,0,0.0,50939840,100.0,2016
The Wailing,49851770,786633,1.6,49065137,98.4,2016
Two Is a Family,49619118,0,0.0,49619118,100.0,2016
Never Gone,48980792,96421,0.2,48884371,99.8,2016
Luck0Key,48913975,466505,1.0,48447470,99.0,2016
Florence Foster Jenkins,48902953,27383770,56.0,21519183,44.0,2016
Mother's Day,48782670,32492859,66.6,16289811,33.4,2016
Yo0kai Watch Movie: It's the Secret of Birth Meow! 2016 Re0release,47642462,0,0.0,47642462,100.0,2016
A Monster Calls,47309313,3740823,7.9,43568490,92.1,2016
Risen,46432579,36880033,79.4,9552546,20.6,2016
Eddie the Eagle,46152800,15789389,34.2,30363411,65.8,2016
Blair Witch,45173154,20777061,46.0,24396093,54.0,2016
Boonie Bears: The Big Top Secret,45150390,0,0.0,45150390,100.0,2016
Caf√© Society,43763247,11103205,25.4,32660042,74.6,2016
League of Gods,43498766,181633,0.4,43317133,99.6,2016
Almost Christmas,42580920,42158780,99.0,422140,1.0,2016
The Witch,40423945,25138705,62.2,15285240,37.8,2016
The Wild Life,40075446,8005586,20.0,32069860,80.0,2016
Love O2O,39969537,0,0.0,39969537,100.0,2016
The Forest,39712000,26594261,67.0,13117739,33.0,2016
Absolutely Fabulous: The Movie,39219109,4772155,12.2,34446954,87.8,2016
My Mom Is a Character 2,39195565,0,0.0,39195565,100.0,2016
Masterpiece Mystery: Sherlock: The Abominable Bride,39139204,0,0.0,39139204,100.0,2016
Crouching Tiger Hidden Dragon: Sword of Destiny,38659039,0,0.0,38659039,100.0,2016
Hell or High Water,37879877,27007844,71.3,10872033,28.7,2016
Mission Milano,37749848,0,0.0,37749848,100.0,2016
The Handmaiden,37692886,2006788,5.3,35686098,94.7,2016
Snowden,37357216,21587519,57.8,15769697,42.2,2016
Nobunaga Concerto: The Movie,36187594,0,0.0,36187594,100.0,2016
Eye in the Sky,35259653,18704595,53.0,16555058,47.0,2016
The Tuche Family: The American Dream,35210425,0,0.0,35210425,100.0,2016
Os Dez Mandamentos 0 O Filme,31998251,0,0.0,31998251,100.0,2016
Bounty Hunters,31918573,0,0.0,31918573,100.0,2016
Ae Dil Hai Mushkil,31668920,4264983,13.5,27403937,86.5,2016
Assassination Classroom: The Graduation,31352921,0,0.0,31352921,100.0,2016
Perfect Strangers,31254929,0,0.0,31254929,100.0,2016
Billy Lynn's Long Halftime Walk,30930984,1738477,5.6,29192507,94.4,2016
Pandora,30896701,0,0.0,30896701,100.0,2016
Norm of the North,30734502,17062499,55.5,13672003,44.5,2016
When the Bough Breaks,30658387,29747603,97.0,910784,3.0,2016
S Storm,30381402,0,0.0,30381402,100.0,2016
Nocturnal Animals,30311857,10663357,35.2,19648500,64.8,2016
A Silent Voice: The Movie,30021659,310407,1.0,29711252,99.0,2016
Keeping Up with the Joneses,29918745,14904426,49.8,15014319,50.2,2016
Jackie,29777777,13960394,46.9,15817383,53.1,2016
Masterminds,29674699,17368022,58.5,12306677,41.5,2016
Flight Crew,29171110,0,0.0,29171110,100.0,2016
Viking,29161298,0,0.0,29161298,100.0,2016
M.S. Dhoni: The Untold Story,28903047,1801550,6.2,27101497,93.8,2016
Fan,28240000,2300000,8.1,25940000,91.9,2016
Y√¥kai Watch: the Movie: The Flying Whale and the Grand Adventure of the Double Worlds Meow!,28110245,0,0.0,28110245,100.0,2016
Welcome to Germany,28036021,0,0.0,28036021,100.0,2016
The Brothers Grimsby,27979040,6874837,24.6,21104203,75.4,2016
When Larry Meets Mary,27863090,0,0.0,27863090,100.0,2016
Yesterday Once More,27413790,0,0.0,27413790,100.0,2016
The Light Between Oceans,25975621,12545979,48.3,13429642,51.7,2016
A Beautiful Planet,25730120,15650615,60.8,10079505,39.2,2016
Mr. Donkey,25537759,356255,1.4,25181504,98.6,2016
Born in China,25081168,13873211,55.3,11207957,44.7,2016
Call of Heroes,25040561,0,0.0,25040561,100.0,2016
Free State of Jones,25035950,20810036,83.1,4225914,16.9,2016
Whiskey Tango Foxtrot,24972139,23083334,92.4,1888805,7.6,2016
Soulmate,24684439,0,0.0,24684439,100.0,2016
The Snow Queen 3: Fire and Ice,24644317,0,0.0,24644317,100.0,2016
God's Not Dead 2,24487848,20774575,84.8,3713273,15.2,2016
Camping 3,24224579,0,0.0,24224579,100.0,2016
The Founder,24121245,12786053,53.0,11335192,47.0,2016
Bad Santa 2,24079268,17782178,73.8,6297090,26.2,2016
Spirits' Homecoming,23857217,125616,0.5,23731601,99.5,2016
Silence,23834809,7100177,29.8,16734632,70.2,2016
Kevin Hart: What Now?,23591043,23591043,100.0,0,0.0,2016
No Manches Frida,23540937,11528613,49.0,12012324,51.0,2016
Middle School: The Worst Years of My Life,23316139,20007149,85.8,3308990,14.2,2016
Triple 9,23177948,12639297,54.5,10538651,45.5,2016
Rock Dog,23139802,9420546,40.7,13719256,59.3,2016
The Choice,23064015,18730891,81.2,4333124,18.8,2016
Penny Pincher!,22955486,0,0.0,22955486,100.0,2016
Star Wars: Episode VIII 0 The Last Jedi,1332539889,620181382,46.5,712358507,53.5,2017
The Fate of the Furious,1236005118,226008385,18.3,1009996733,81.7,2017
Despicable Me 3,1034799409,264624300,25.6,770175109,74.4,2017
Jumanji: Welcome to the Jungle,962077546,404515480,42.0,557562066,58.0,2017
Spider0Man: Homecoming,880166924,334201140,38.0,545965784,62.0,2017
Wolf Warrior 2,870325439,2721100,0.3,867604339,99.7,2017
Guardians of the Galaxy Vol. 2,863756051,389813101,45.1,473942950,54.9,2017
Thor: Ragnarok,853977126,315058289,36.9,538918837,63.1,2017
Wonder Woman,822963408,412563408,50.1,410400000,49.9,2017
Pirates of the Caribbean: Dead Men Tell No Tales,794861794,172558876,21.7,622302918,78.3,2017
It,702781748,327481748,46.6,375300000,53.4,2017
Justice League,661324295,229024295,34.6,432300000,65.4,2017
Logan,619021436,226277068,36.6,392744368,63.4,2017
Transformers: The Last Knight,605425157,130168683,21.5,475256474,78.5,2017
Kong: Skull Island,568652812,168052812,29.6,400600000,70.4,2017
The Boss Baby,527965936,175003033,33.1,352962903,66.9,2017
Dunkirk,526045546,188045546,35.7,338000000,64.3,2017
War for the Planet of the Apes,490719763,146880162,29.9,343839601,70.1,2017
The Greatest Showman,434993183,174340174,40.1,260653009,59.9,2017
Kingsman: The Golden Circle,410902662,100234838,24.4,310667824,75.6,2017
The Mummy,409231607,80227895,19.6,329003712,80.4,2017
Cars 3,383930656,152901115,39.8,231029541,60.2,2017
Fifty Shades Darker,381545846,114581250,30.0,266964596,70.0,2017
Murder on the Orient Express,352789811,102826543,29.1,249963268,70.9,2017
xXx: Return of Xander Cage,346118277,44898413,13.0,301219864,87.0,2017
Never Say Die,334530869,0,0.0,334530869,100.0,2017
The Lego Batman Movie,312150384,175750384,56.3,136400000,43.7,2017
The Ex0File 3: Return of the Exes,307592427,838959,0.3,306753468,99.7,2017
Annabelle: Creation,306592201,102092201,33.3,204500000,66.7,2017
Wonder,305937718,132422809,43.3,173514909,56.7,2017
Ferdinand,296069199,84410380,28.5,211658819,71.5,2017
Split,278454358,138291365,49.7,140162993,50.3,2017
Blade Runner 2049,259154159,92054159,35.5,167100000,64.5,2017
Kung Fu Yoga,257743016,362657,0.1,257380359,99.9,2017
Get Out,255407969,176040665,68.9,79367304,31.1,2017
Baahubali 2: The Conclusion,254158390,20186659,7.9,233971731,92.1,2017
Journey to the West: The Demons Strike Back,247585244,880346,0.4,246704898,99.6,2017
Alien: Covenant,240891763,74262031,30.8,166629732,69.2,2017
Paddington 2,227291591,40891591,18.0,186400000,82.0,2017
Youth,227091290,1891956,0.8,225199334,99.2,2017
Baby Driver,226945087,107825862,47.5,119119225,52.5,2017
Valerian and the City of a Thousand Planets,225874228,41189488,18.2,184684740,81.8,2017
Geostorm,221900160,33700160,15.2,188200000,84.8,2017
The Emoji Movie,217776646,86089513,39.5,131687133,60.5,2017
A Dog's Purpose,205035819,64508620,31.5,140527199,68.5,2017
Smurfs: The Lost Village,197183546,45020282,22.8,152163264,77.2,2017
The Shape of Water,195243464,63859435,32.7,131384029,67.3,2017
Pitch Perfect 3,185400345,104897530,56.6,80502815,43.4,2017
The Hitman's Bodyguard,183415183,75468583,41.1,107946600,58.9,2017
Daddy's Home 2,180613180,104029443,57.6,76583737,42.4,2017
The Post,179769457,81903458,45.6,97865999,54.4,2017
Baywatch,177856751,58060186,32.6,119796565,67.4,2017
John Wick: Chapter 2,171539887,92029184,53.6,79510703,46.4,2017
Ghost in the Shell,169801921,40563557,23.9,129238364,76.1,2017
Three Billboards Outside Ebbing Missouri,160060063,54513740,34.1,105546323,65.9,2017
Duckweed,152894264,471575,0.3,152422689,99.7,2017
Darkest Hour,150847207,56468410,37.4,94378797,62.6,2017
King Arthur: Legend of the Sword,149175066,39175066,26.3,110000000,73.7,2017
The Foreigner,145374099,34393507,23.7,110980592,76.3,2017
Power Rangers,142337240,85364450,60.0,56972790,40.0,2017
Girls Trip,140552359,115171585,81.9,25380774,18.1,2017
American Made,134866593,51342000,38.1,83524593,61.9,2017
A Bad Moms Christmas,130560428,72110659,55.2,58449769,44.8,2017
Happy Death Day,125479266,55683845,44.4,69795421,55.6,2017
Captain Underpants: The First Epic Movie,125427681,73921000,58.9,51506681,41.1,2017
The Lego Ninjago Movie,123681555,59281555,47.9,64400000,52.1,2017
Secret Superstar,122026260,0,0.0,122026260,100.0,2017
The Commuter,119942387,36343858,30.3,83598529,69.7,2017
The Dark Tower,113231078,50701325,44.8,62529753,55.2,2017
Buddies in India,110155128,293194,0.3,109861934,99.7,2017
Along With the Gods: The Two Worlds,109383972,1908823,1.7,107475149,98.3,2017
Immortal Demon Slayer,103818506,0,0.0,103818506,100.0,2017
Jigsaw,102952888,38052832,37.0,64900056,63.0,2017
Life,100541806,30234022,30.1,70307784,69.9,2017
Atomic Blonde,100014025,51687870,51.7,48326155,48.3,2017
Legend of the Demon Cat,97051623,0,0.0,97051623,100.0,2017
The Shack,96942115,57386418,59.2,39555697,40.8,2017
Chasing the Dragon,87965942,456854,0.5,87509088,99.5,2017
Tiger Zinda Hai,87320000,5560921,6.4,81759079,93.6,2017
A Taxi Driver,86252940,1527829,1.8,84725111,98.2,2017
Going in Style,85218541,45018541,52.8,40200000,47.2,2017
Rings,83080890,27793018,33.5,55287872,66.5,2017
Once Upon A Time,82886178,485728,0.6,82400450,99.4,2017
Paradox,79226860,0,0.0,79226860,100.0,2017
Lady Bird,78965611,48958273,62.0,30007338,38.0,2017
Fantastica: A Boonie Bears Adventure,77151096,0,0.0,77151096,100.0,2017
The Nut Job 2: Nutty by Nature,68743485,28370522,41.3,40372963,58.7,2017
American Assassin,67234188,36249674,53.9,30984514,46.1,2017
Victoria & Abdul,66558465,22245070,33.4,44313395,66.6,2017
Suck Me Shakespeer 3,64236772,0,0.0,64236772,100.0,2017
Detective Conan: Crimson Love Letter,63144805,0,0.0,63144805,100.0,2017
The Mountain Between Us,62832209,30348555,48.3,32483654,51.7,2017
The Star,62812974,40852824,65.0,21960150,35.0,2017
How to Be a Latin Lover,62547032,32149404,51.4,30397628,48.6,2017
47 Meters Down,62187529,44307191,71.2,17880338,28.8,2017
Everything Everything,61721140,34121140,55.3,27600000,44.7,2017
Doraemon: Great Adventure in the Antarctic Kachi Kochi,61153455,0,0.0,61153455,100.0,2017
Snatched,60845711,45852178,75.4,14993533,24.6,2017
The Founding of an Army,60600361,0,0.0,60600361,100.0,2017
My Little Pony: The Movie,60330833,21885107,36.3,38445726,63.7,2017
Molly's Game,59284015,28780744,48.5,30503271,51.5,2017
Xian yi ren X de xian shen,59035664,686435,1.2,58349229,98.8,2017
Shock Wave,58824459,0,0.0,58824459,100.0,2017
Goldbuster,57628292,186135,0.3,57442157,99.7,2017
All the Money in the World,56996304,25113707,44.1,31882597,55.9,2017
The Big Sick,56411585,42873127,76.0,13538458,24.0,2017
Confidential Assignment,55972241,475618,0.8,55496623,99.2,2017
All Eyez on Me,55668698,44922302,80.7,10746396,19.3,2017
Downsizing,55003890,24449754,44.5,30554136,55.5,2017
I Tonya,53939297,30014539,55.6,23924758,44.4,2017
1987: When the Day Comes,53834292,0,0.0,53834292,100.0,2017
The Outlaws,52946454,0,0.0,52946454,100.0,2017
Bleeding Steel,48825526,0,0.0,48825526,100.0,2017
Logan Lucky,48453605,27780977,57.3,20672628,42.7,2017
Boo 2! A Madea Halloween,48333932,47319572,97.9,1014360,2.1,2017
Sky Hunter,48065601,0,0.0,48065601,100.0,2017
Phantom Thread,47756590,21198205,44.4,26558385,55.6,2017
Rough Night,47347283,22105643,46.7,25241640,53.3,2017
Son of Bigfoot,47046281,289308,0.6,46756973,99.4,2017
Three Seconds,46596415,0,0.0,46596415,100.0,2017
The Thousand Faces of Dunjia,46263237,124187,0.3,46139050,99.7,2017
The Battleship Island,46183383,1104957,2.4,45078426,97.6,2017
Hanson and the Beast,46154323,0,0.0,46154323,100.0,2017
Gintama Live Action the Movie,45746967,0,0.0,45746967,100.0,2017
Guilty of Mind,45698503,0,0.0,45698503,100.0,2017
Flatliners,45158254,16883115,37.4,28275139,62.6,2017
Bad Genius,44560421,0,0.0,44560421,100.0,2017
Mother!,44516999,17800004,40.0,26716995,60.0,2017
Wind River,43980821,33800859,76.9,10179962,23.1,2017
Battle of Memories,43892362,594552,1.4,43297810,98.6,2017
The Snowman,43155261,6700035,15.5,36455226,84.5,2017
Gifted,43046590,24801212,57.6,18245378,42.4,2017
Loving Vincent,42187665,6735118,16.0,35452547,84.0,2017
Call Me by Your Name,42112584,18095701,43.0,24016883,57.0,2017
Mary and the Witch's Flower,41978431,2418404,5.8,39560027,94.2,2017
T2 Trainspotting,41681746,2402004,5.8,39279742,94.2,2017
Fist Fight,41187017,32187017,78.1,9000000,21.9,2017
The Circle,40656399,20497844,50.4,20158555,49.6,2017
Diary of a Wimpy Kid: The Long Haul,40140972,20738724,51.7,19402248,48.3,2017
Brotherhood of Blades 2,39966092,14204,0.0,39951888,100.0,2017
Midnight Runners,39730433,0,0.0,39730433,100.0,2017
The King,37886707,0,0.0,37886707,100.0,2017
Pok√©mon the Movie: I Choose You!,37552144,2401722,6.4,35150422,93.6,2017
Home Again,37270721,27020284,72.5,10250437,27.5,2017
The Adventurers,36796816,216556,0.6,36580260,99.4,2017
Tad the Lost Explorer and the Secret of King Midas,35704046,5874,0.0,35698172,100.0,2017
Hostiles,35669017,29819114,83.6,5849903,16.4,2017
Namiya,35351623,70814,0.2,35280809,99.8,2017
Destiny: The Tale of Kamakura,35166640,0,0.0,35166640,100.0,2017
The Liquidator,35046130,0,0.0,35046130,100.0,2017
Kidnap,34814102,30971040,89.0,3843062,11.0,2017
R.A.I.D. Special Unit,34598750,0,0.0,34598750,100.0,2017
The House,34284504,25584504,74.6,8700000,25.4,2017
I Want to Eat Your Pancreas,33748006,277019,0.8,33470987,99.2,2017
Sleepless,32917353,20783704,63.1,12133649,36.9,2017
Hindi Medium,32841493,0,0.0,32841493,100.0,2017
Steel Rain,32783733,0,0.0,32783733,100.0,2017
The House That Never Dies II,32433588,0,0.0,32433588,100.0,2017
The Invisible Guest,31191910,0,0.0,31191910,100.0,2017
This Is Not What I Expected,30996615,337670,1.1,30658945,98.9,2017
The Last Warrior,30618274,0,0.0,30618274,100.0,2017
Reset 2017 Re0release,29949252,108970,0.4,29840282,99.6,2017
The Bye Bye Man,29874280,22395806,75.0,7478474,25.0,2017
The Disaster Artist,29820616,21120616,70.8,8700000,29.2,2017
The Swindlers,29721916,241916,0.8,29480000,99.2,2017
Alibi.com,29370592,0,0.0,29370592,100.0,2017
Sword Art Online the Movie: Ordinal Scale,29322339,1522976,5.2,27799363,94.8,2017
Recep Ivedik 5,28952258,0,0.0,28952258,100.0,2017
Judwaa 2,28733523,1431255,5.0,27302268,95.0,2017
The Fortress,28645448,252895,0.9,28392553,99.1,2017
What Happened to Monday,27975429,0,0.0,27975429,100.0,2017
Monster Family,27890108,127259,0.5,27762849,99.5,2017
The Beguiled,27869129,10709995,38.4,17159134,61.6,2017
CHIPS,26800152,18600152,69.4,8200000,30.6,2017
A Cure for Wellness,26620002,8106986,30.5,18513016,69.5,2017
Only the Brave,26351322,18343983,69.6,8007339,30.4,2017
Twenty Two,26289378,46796,0.2,26242582,99.8,2017
The Zookeeper's Wife,26152835,17571660,67.2,8581175,32.8,2017
The Bride of Badrinath,26134309,1993259,7.6,24141050,92.4,2017
A Chinese Odyssey: Part 2 0 Cinderella 2017 Re0release,25960664,0,0.0,25960664,100.0,2017
Love Off the Cuff,25959989,0,0.0,25959989,100.0,2017
Father Figures,25701244,17501244,68.1,8200000,31.9,2017
Fireworks,25672406,525280,2.0,25147126,98.0,2017
Money,25403753,0,0.0,25403753,100.0,2017
Leap! 2017 Re0release,25376094,21858070,86.1,3518024,13.9,2017
The Death of Stalin,24646055,8047856,32.7,16598199,67.3,2017
The 80Year Engagement,24425963,0,0.0,24425963,100.0,2017
Jolly LLB 2,24214186,1654254,6.8,22559932,93.2,2017
I Can Speak,24024444,63239,0.3,23961205,99.7,2017
Wish Upon,23468586,14301505,60.9,9167081,39.1,2017
Detroit,23355100,16790139,71.9,6564961,28.1,2017
Extraordinary Mission,22757764,54174,0.2,22703590,99.8,2017
The Glass Castle,22088533,17273059,78.2,4815474,21.8,2017
√âpouse0moi mon pote,21571464,0,0.0,21571464,100.0,2017
The Prison,21205329,207481,1.0,20997848,99.0,2017
One Hundred Thousand Bad Jokes 2,20460352,0,0.0,20460352,100.0,2017
Avengers: Infinity War,2048359754,678815482,33.1,1369544272,66.9,2018
Black Panther,1346913161,700059566,52.0,646853595,48.0,2018
Jurassic World: Fallen Kingdom,1308467944,417719760,31.9,890748184,68.1,2018
Incredibles 2,1242805359,608581744,49.0,634223615,51.0,2018
Aquaman,1151961807,335061807,29.1,816900000,70.9,2018
Bohemian Rhapsody,903655259,216428042,24.0,687227217,76.0,2018
Venom,856085151,213515506,24.9,642569645,75.1,2018
Mission: Impossible 0 Fallout,791115104,220159104,27.8,570956000,72.2,2018
Deadpool 2,734546611,318491426,43.4,416055185,56.6,2018
Fantastic Beasts: The Crimes of Grindelwald,655755901,159555901,24.3,496200000,75.7,2018
Ant0Man and the Wasp,622674139,216648740,34.8,406025399,65.2,2018
Ready Player One,583490172,137690172,23.6,445800000,76.4,2018
Operation Red Sea,579330426,1543547,0.3,577786879,99.7,2018
Detective Chinatown 2,544185156,1983984,0.4,542201172,99.6,2018
Ralph Breaks the Internet,529323962,201091711,38.0,328232251,62.0,2018
The Meg,529243742,145443742,27.5,383800000,72.5,2018
Hotel Transylvania 3: Summer Vacation,528583774,167510016,31.7,361073758,68.3,2018
The Grinch,512453517,271478510,53.0,240975007,47.0,2018
Bumblebee,467989645,127195589,27.2,340794056,72.8,2018
Dying to Survive,451176639,0,0.0,451176639,100.0,2018
A Star Is Born,436388866,215288866,49.3,221100000,50.7,2018
Rampage,428128233,101028233,23.6,327100000,76.4,2018
Mamma Mia! Here We Go Again,395044706,120634935,30.5,274409771,69.5,2018
Solo: A Star Wars Story,392924807,213767512,54.4,179157295,45.6,2018
Spider0Man: Into the Spider0Verse,375582637,190241310,50.7,185341327,49.3,2018
Fifty Shades Freed,371985018,100407760,27.0,271577258,73.0,2018
Hello Mr. Billionaire,366961907,0,0.0,366961907,100.0,2018
The Nun,366050119,117450119,32.1,248600000,67.9,2018
Monster Hunt 2,361682618,706153,0.2,360976465,99.8,2018
Peter Rabbit,351266433,115253424,32.8,236013009,67.2,2018
Mary Poppins Returns,349537494,171958438,49.2,177579056,50.8,2018
A Quiet Place,340939361,188024361,55.1,152915000,44.9,2018
Green Book,321752656,85080171,26.4,236672485,73.6,2018
Skyscraper,304868961,68420120,22.4,236448841,77.6,2018
Ocean's Eight,297718711,140218711,47.1,157500000,52.9,2018
Pacific Rim: Uprising,290930148,59874525,20.6,231055623,79.4,2018
Maze Runner: The Death Cure,288175335,58032443,20.1,230142892,79.9,2018
Tomb Raider,274950803,58250803,21.2,216700000,78.8,2018
Crazy Rich Asians,239032921,174532921,73.0,64500000,27.0,2018
Smallfoot,217940103,83240103,38.2,134700000,61.8,2018
Creed II,214215889,115715889,54.0,98500000,46.0,2018
Us and Them,209221380,0,0.0,209221380,100.0,2018
Christopher Robin,197744377,99215042,50.2,98529335,49.8,2018
The Equalizer 2,190400157,102084362,53.6,88315795,46.4,2018
Project Gutenberg,188116796,0,0.0,188116796,100.0,2018
The Mule,174804407,103804407,59.4,71000000,40.6,2018
The Nutcracker and the Four Realms,173961069,54858851,31.5,119102218,68.5,2018
Insidious: The Last Key,167885588,67745330,40.4,100140258,59.6,2018
The Predator,160542134,51024708,31.8,109517426,68.2,2018
Johnny English Strikes Again,158970776,4412170,2.8,154558606,97.2,2018
Red Sparrow,151572634,46874505,30.9,104698129,69.1,2018
More Than Blue,142958164,722669,0.5,142235495,99.5,2018
The First Purge,137056262,69488745,50.7,67567517,49.3,2018
How Long Will I Love U,136796719,746933,0.5,136049786,99.5,2018
A Wrinkle in Time,132675864,100478608,75.7,32197256,24.3,2018
The House with a Clock in Its Walls,131457147,68549695,52.1,62907452,47.9,2018
Instant Family,120556201,67363237,55.9,53192964,44.1,2018
A Cool Fish,118153135,551876,0.5,117601259,99.5,2018
Game Night,117679066,69179066,58.8,48500000,41.2,2018
Dragon Ball Super: Broly,115750445,30712119,26.5,85038326,73.5,2018
The Monkey King 3,115084576,187074,0.2,114897502,99.8,2018
First Man,105697415,44936545,42.5,60760870,57.5,2018
Book Club,104438188,68566296,65.7,35871892,34.3,2018
Night School,103105878,77339130,75.0,25766748,25.0,2018
Detective Conan: Zero the Enforcer,101860359,0,0.0,101860359,100.0,2018
Alpha,99630675,35857181,36.0,63773494,64.0,2018
Along With the Gods: The Last 49 Days,97962238,1200246,1.2,96761992,98.8,2018
A Simple Favor,97644617,53548586,54.8,44096031,45.2,2018
Boonie Bears: The Big Shrink,96845907,0,0.0,96845907,100.0,2018
The Favourite,95918706,34366783,35.8,61551923,64.2,2018
Truth or Dare,95330493,41411015,43.4,53919478,56.6,2018
Kill Mobile,94870905,0,0.0,94870905,100.0,2018
I Feel Pretty,94539426,48795601,51.6,45743825,48.4,2018
Blockers,94017294,60311495,64.1,33705799,35.9,2018
BlacKkKlansman,93400823,49275340,52.8,44125483,47.2,2018
Goosebumps 2: Haunted Halloween,93320380,46700633,50.0,46619747,50.0,2018
Shadow,91708374,521396,0.6,91186978,99.4,2018
Overboard,91244913,50316123,55.1,40928790,44.9,2018
Sherlock Gnomes,90497778,43242871,47.8,47254907,52.2,2018
Detective Dee: The Four Heavenly Kings,90040771,262963,0.3,89777808,99.7,2018
Hello Mrs. Money,86874070,0,0.0,86874070,100.0,2018
I Can Only Imagine,86086881,83482352,97.0,2604529,3.0,2018
Hidden Man,85170581,0,0.0,85170581,100.0,2018
Mortal Engines,83672673,15951040,19.1,67721633,80.9,2018
iPartment the Movie,81096321,0,0.0,81096321,100.0,2018
Doraemon the Movie: Nobita's Treasure Island,80920916,0,0.0,80920916,100.0,2018
Den of Thieves,80509622,44947622,55.8,35562000,44.2,2018
Hereditary,80003155,44069456,55.1,35933699,44.9,2018
Code Blue: The Movie,78778562,0,0.0,78778562,100.0,2018
Tag,78230625,54730625,70.0,23500000,30.0,2018
Sanju,76693052,7909317,10.3,68783735,89.7,2018
Vice,76073488,47836282,62.9,28237206,37.1,2018
Widows,75984700,42402632,55.8,33582068,44.2,2018
Sicario: Day of the Soldado,75837743,50072235,66.0,25765508,34.0,2018
Searching,75462037,26020957,34.5,49441080,65.5,2018
The Spy Who Dumped Me,75320680,33562069,44.6,41758611,55.4,2018
Animal World,74922830,0,0.0,74922830,100.0,2018
Amazing China,72506343,0,0.0,72506343,100.0,2018
Second Act,72282227,39282227,54.3,33000000,45.7,2018
Spirited Away 2018 Re0release,70186029,1175067,1.7,69010962,98.3,2018
Shoplifters,67999335,3313513,4.9,64685822,95.1,2018
12 Strong,67359190,45819713,68.0,21539477,32.0,2018
Love Simon,66316289,40826341,61.6,25489948,38.4,2018
Mile 22,66308758,36108758,54.5,30200000,45.5,2018
Life of the Party,65659911,53059911,80.8,12600000,19.2,2018
L Storm,64517456,0,0.0,64517456,100.0,2018
Capernaum,64417003,1661096,2.6,62755907,97.4,2018
Isle of Dogs,64241499,32015231,49.8,32226268,50.2,2018
Andhadhun,62475342,1193046,1.9,61282296,98.1,2018
Adrift,59945012,31445012,52.5,28500000,47.5,2018
The 15:17 to Paris,57176286,36276286,63.4,20900000,36.6,2018
A or B,56239049,0,0.0,56239049,100.0,2018
Go Brother!,54663060,0,0.0,54663060,100.0,2018
Early Man,54622814,8267544,15.1,46355270,84.9,2018
Peppermint,53918723,35418723,65.7,18500000,34.3,2018
Teen Titans GO! To the Movies,52390236,29790236,56.9,22600000,43.1,2018
Slender Man,51738549,30569484,59.1,21169065,40.9,2018
Breaking In,51411620,46840590,91.1,4571030,8.9,2018
Cry Me a Sad River,51400614,0,0.0,51400614,100.0,2018
Once Upon a Deadpool 2018 Re0release,51349833,6100309,11.9,45249524,88.1,2018
Simmba,51329025,5102129,9.9,46226896,90.1,2018
Family is Family,49954866,0,0.0,49954866,100.0,2018
Death Wish,49562710,34017028,68.6,15545682,31.4,2018
The Magic Tuche,47427990,0,0.0,47427990,100.0,2018
Golden Job,47287851,285795,0.6,47002056,99.4,2018
Mary Queen of Scots,46712809,16468499,35.3,30244310,64.7,2018
Uncle Drew,46664414,42469946,91.0,4194468,9.0,2018
Acrimony,46403669,43549096,93.8,2854573,6.2,2018
Asterix: The Secret of the Magic Potion,46215959,1271953,2.8,44944006,97.2,2018
Bajrangi Bhaijaan 2018 Re0release,45579004,0,0.0,45579004,100.0,2018
Winchester,44019588,25091816,57.0,18927772,43.0,2018
Annihilation,43070915,32732301,76.0,10338614,24.0,2018
The Possession of Hannah Grace,43016528,14837422,34.5,28179106,65.5,2018
Long Day's Journey Into Night,42140994,521365,1.2,41619629,98.8,2018
Overlord,41657844,21704844,52.1,19953000,47.9,2018
The Great Battle,41509280,472166,1.1,41037114,98.9,2018
The Darkest Minds,41142379,12695691,30.9,28446688,69.1,2018
Lost Found,41043552,0,0.0,41043552,100.0,2018
Holmes & Watson,40466970,30573626,75.6,9893344,24.4,2018
Intimate Strangers,39576060,0,0.0,39576060,100.0,2018
Thugs of Hindostan,39570044,1449848,3.7,38120196,96.3,2018
Sink or Swim,39193850,0,0.0,39193850,100.0,2018
Show Dogs,39156854,17857020,45.6,21299834,54.4,2018
Believer,39047153,365639,0.9,38681514,99.1,2018
The Spy Gone North,38844509,500803,1.3,38343706,98.7,2018
On the Basis of Sex,38673750,24622687,63.7,14051063,36.3,2018
Taxi 5,38598227,0,0.0,38598227,100.0,2018
Fat Buddies,37496410,0,0.0,37496410,100.0,2018
Till The End Of The World,37013733,118660,0.3,36895073,99.7,2018
2,36945969,4152000,11.2,32793969,88.8,2018
Nothing to Lose,36075317,1016188,2.8,35059129,97.2,2018
Mia and the White Lion,35487190,399471,1.1,35087719,98.9,2018
The Girl in the Spider's Web,35164920,14841338,42.2,20323582,57.8,2018
The Hate U Give,34934009,29719483,85.1,5214526,14.9,2018
Nobody's Fool,33705333,31713110,94.1,1992223,5.9,2018
Baaghi 2,33139063,1319579,4.0,31819484,96.0,2018
The Hurricane Heist,32517248,6115825,18.8,26401423,81.2,2018
All About Me,31920159,0,0.0,31920159,100.0,2018
Bad Times at the El Royale,31882724,17839115,56.0,14043609,44.0,2018
Beautiful Boy,31711319,7649973,24.1,24061346,75.9,2018
Hunter Killer,31672678,15767460,49.8,15905218,50.2,2018
Super Troopers 2,31626386,30617396,96.8,1008990,3.2,2018
The Strangers: Prey at Night,31039126,24586708,79.2,6452418,20.8,2018
Gintama 2: Rules are Made to be Broken,30896653,0,0.0,30896653,100.0,2018
The Way of the Bug,30355804,0,0.0,30355804,100.0,2018
Clergy,30114115,0,0.0,30114115,100.0,2018
Ice,29806210,0,0.0,29806210,100.0,2018
Free Solo,29390279,17541090,59.7,11849189,40.3,2018
Dark Figure of Crime,29176133,0,0.0,29176133,100.0,2018
Pad Man,29045020,1670192,5.8,27374828,94.2,2018
Mirai,28756961,812794,2.8,27944167,97.2,2018
Default,27694043,203775,0.7,27490268,99.3,2018
One Cut of the Dead,27590180,52406,0.2,27537774,99.8,2018
The Happytime Murders,27506452,20706452,75.3,6800000,24.7,2018
Midnight Sun,27365467,9561064,34.9,17804403,65.1,2018
VIP Policeman,27222681,0,0.0,27222681,100.0,2018
My Neighbor Totoro 2018 Re0release,27083857,1144649,4.2,25939208,95.8,2018
The Faces of My Gene,26796279,0,0.0,26796279,100.0,2018
Badhaai Ho,26125610,0,0.0,26125610,100.0,2018
Hichki,26055222,330279,1.3,25724943,98.7,2018
Champions,25962612,0,0.0,25962612,100.0,2018
White Boy Rick,25957482,24011188,92.5,1946294,7.5,2018
Paul Apostle of Christ,25915966,17560475,67.8,8355491,32.2,2018
Keys to the Heart,25375866,75134,0.3,25300732,99.7,2018
Stan & Ollie,24420923,5470235,22.4,18950688,77.6,2018
The Witch: Part 1 0 The Subversion,24340302,0,0.0,24340302,100.0,2018
The Accidental Detective 2: In Action,24243825,179045,0.7,24064780,99.3,2018
Killing for the Prosecution,23929620,0,0.0,23929620,100.0,2018
Pok√©mon the Movie: The Power of Us,23740788,789170,3.3,22951618,96.7,2018
The Guernsey Literary and Potato Peel Pie Society,23148937,0,0.0,23148937,100.0,2018
The Crimes That Bind,23144130,0,0.0,23144130,100.0,2018
New Happy Dad and Son 3: Adventure in Russia,23130469,0,0.0,23130469,100.0,2018
Padmaavat,22991060,11846060,51.5,11145000,48.5,2018
Won't You Be My Neighbor?,22844741,22835787,100.0,8954,0.0,2018
Europe Raiders,22435156,0,0.0,22435156,100.0,2018
Mojin: The Worm Valley,22381583,101516,0.5,22280067,99.5,2018
Stree,22075730,0,0.0,22075730,100.0,2018
Avengers: Endgame,2799439100,858373000,30.7,1941066100,69.3,2019
The Lion King,1656943394,543638043,32.8,1113305351,67.2,2019
Frozen II,1450026933,477373578,32.9,972653355,67.1,2019
Spider0Man: Far from Home,1131927996,390532085,34.5,741395911,65.5,2019
Captain Marvel,1128274794,426829839,37.8,701444955,62.2,2019
Joker,1078751311,335451311,31.1,743300000,68.9,2019
Star Wars: Episode IX 0 The Rise of Skywalker,1074144248,515202542,48.0,558941706,52.0,2019
Toy Story 4,1073394593,434038008,40.4,639356585,59.6,2019
Aladdin,1050693953,355559216,33.8,695134737,66.2,2019
Jumanji: The Next Level,801693929,320314960,40.0,481378969,60.0,2019
Fast & Furious Presents: Hobbs & Shaw,760732926,173956935,22.9,586775991,77.1,2019
Ne Zha,726063471,3695533,0.5,722367938,99.5,2019
The Wandering Earth,699856699,5971413,0.9,693885286,99.1,2019
How to Train Your Dragon: The Hidden World,521799505,160799505,30.8,361000000,69.2,2019
Maleficent: Mistress of Evil,491730089,113929605,23.2,377800484,76.8,2019
It Chapter Two,473093228,211593228,44.7,261500000,55.3,2019
My People My Country,450064993,2356683,0.5,447708310,99.5,2019
Pok√©mon: Detective Pikachu,433305346,144105346,33.3,289200000,66.7,2019
The Secret Life of Pets 2,431164459,158980250,36.9,272184209,63.1,2019
The Captain,417282021,706572,0.2,416575449,99.8,2019
Alita: Battle Angel,404980543,85838210,21.2,319142333,78.8,2019
Godzilla: King of the Monsters,387300138,110500138,28.5,276800000,71.5,2019
1917,384580017,159227644,41.4,225352373,58.6,2019
Once Upon a Time... in Hollywood,377426903,142502728,37.8,234924175,62.2,2019
Shazam!,365971656,140371656,38.4,225600000,61.6,2019
Dumbo,353284621,114766307,32.5,238518314,67.5,2019
John Wick: Chapter 3 0 Parabellum,327777335,171015687,52.2,156761648,47.8,2019
Crazy Alien,327598891,0,0.0,327598891,100.0,2019
Knives Out,312897920,165363234,52.8,147534686,47.2,2019
Terminator: Dark Fate,261119292,62253077,23.8,198866215,76.2,2019
Parasite,258129037,53369749,20.7,204759288,79.3,2019
Us,256022707,175084580,68.4,80938127,31.6,2019
Pegasus,255863112,0,0.0,255863112,100.0,2019
Men in Black: International,253890701,80001807,31.5,173888894,68.5,2019
X0Men: Dark Phoenix,252442974,65845974,26.1,186597000,73.9,2019
Glass,246999039,111048468,45.0,135950571,55.0,2019
The Bravest,245179562,290217,0.1,244889345,99.9,2019
Annabelle Comes Home,231252591,74152591,32.1,157100000,67.9,2019
Better Days,225833113,1921657,0.9,223911456,99.1,2019
Ford v Ferrari,225508210,117624357,52.2,107883853,47.8,2019
Little Women,218843645,108101214,49.4,110742431,50.6,2019
The Addams Family,203044905,100044905,49.3,103000000,50.7,2019
Rocketman,195320400,96368160,49.3,98952240,50.7,2019
Downton Abbey,194694725,96853865,49.7,97840860,50.3,2019
The Lego Movie 2: The Second Part,192306508,105806508,55.0,86500000,45.0,2019
Weathering with You,192011547,8056636,4.2,183954911,95.8,2019
Sheep Without a Shepherd,191602146,0,0.0,191602146,100.0,2019
The White Storm 2: Drug Lords,189396380,609461,0.3,188786919,99.7,2019
Abominable,188623517,60716390,32.2,127907127,67.8,2019
Ip Man 4: The Finale,176345966,3956031,2.2,172389935,97.8,2019
Gemini Man,173469516,48546770,28.0,124922746,72.0,2019
Spies in Disguise,171616764,66757013,38.9,104859751,61.1,2019
Hustlers,157563598,104963598,66.6,52600000,33.4,2019
The Climbers,156892866,487157,0.3,156405709,99.7,2019
Escape Room,155712077,57005601,36.6,98706476,63.4,2019
Yesterday,154608856,73286650,47.4,81322206,52.6,2019
The Angry Birds Movie 2,147792047,41667116,28.2,106124931,71.8,2019
Angel Has Fallen,146661977,69030436,47.1,77631541,52.9,2019
Ad Astra,127461872,50188370,39.4,77273502,60.6,2019
Midway,127390389,56846802,44.6,70543587,55.4,2019
The Upside,125852517,108252517,86.0,17600000,14.0,2019
Last Christmas,123446172,35150750,28.5,88295422,71.5,2019
The Curse of La Llorona,123233739,54733739,44.4,68500000,55.6,2019
Looking Up,122994583,84267,0.0,122910316,99.9,2019
Zombieland: Double Tap,122810399,73123082,59.5,49687317,40.5,2019
Dora and the Lost City of Gold,120597108,60477943,50.1,60119165,49.9,2019
Extreme Job,119932733,1565885,1.3,118366848,98.7,2019
Wonder Park,119559110,45216793,37.8,74342317,62.2,2019
P Storm,117991727,326711,0.3,117665016,99.7,2019
Detective Conan: The Fist of Blue Sapphire,115448200,0,0.0,115448200,100.0,2019
The Gentlemen,115171795,36471795,31.7,78700000,68.3,2019
Pet Sematary,113118226,54724696,48.4,58393530,51.6,2019
Boonie Bears: Blast Into the Past,112367881,0,0.0,112367881,100.0,2019
Good Boys,111173598,83140306,74.8,28033292,25.2,2019
Scary Stories to Tell in the Dark,104545505,68947075,65.9,35598430,34.1,2019
Line Walker 2: Invisible Spy,99482027,296751,0.3,99185276,99.7,2019
The Hustle,97409779,35417038,36.4,61992741,63.6,2019
The New King of Comedy,95618308,0,0.0,95618308,100.0,2019
Adoring,94975692,0,0.0,94975692,100.0,2019
Five Feet Apart,92554209,45729221,49.4,46824988,50.6,2019
Crawl,91542097,39014193,42.6,52527904,57.4,2019
Rambo: Last Blood,91490353,44819352,49.0,46671001,51.0,2019
Jojo Rabbit,90335025,33370906,36.9,56964119,63.1,2019
Serial (Bad) Weddings 2,87761988,0,0.0,87761988,100.0,2019
One Piece: Stampede,81562741,1298528,1.6,80264213,98.4,2019
A Dog's Way Home,80708134,42004346,52.0,38703788,48.0,2019
A Dog's Journey,78870908,22782371,28.9,56088537,71.1,2019
Cold Pursuit,76419755,32138862,42.1,44280893,57.9,2019
Cats,75558925,27166770,36.0,48392155,64.0,2019
A Madea Family Funeral,74747725,73257045,98.0,1490680,2.0,2019
Doctor Sleep,72381712,31581712,43.6,40800000,56.4,2019
What Men Want,72216294,54611903,75.6,17604391,24.4,2019
Exit,69501772,470699,0.7,69031073,99.3,2019
After,69497587,12138565,17.5,57359022,82.5,2019
Playing with Fire,69412425,44451847,64.0,24960578,36.0,2019
A Beautiful Day in the Neighborhood,67925733,61704055,90.8,6221678,9.2,2019
Doraemon: Nobita's Chronicle of the Moon Exploration,65406606,0,0.0,65406606,100.0,2019
Happy Death Day 2U,64600152,28148130,43.6,36452022,56.4,2019
White Snake,62098770,34730,0.0,62064040,99.9,2019
Bombshell,61404394,31762808,51.7,29641586,48.3,2019
Ashfall,61354854,372562,0.6,60982292,99.4,2019
Ma,61220784,45896028,75.0,15324756,25.0,2019
My Best Summer,60011073,0,0.0,60011073,100.0,2019
Ready or Not,57615777,28714231,49.8,28901546,50.2,2019
Jade Dynasty,57149764,0,0.0,57149764,100.0,2019
The Perfect Secret,56573047,0,0.0,56573047,100.0,2019
The Big Shot,56040681,0,0.0,56040681,100.0,2019
Long Shot,53873809,30316271,56.3,23557538,43.7,2019
Just Mercy,50901502,36001502,70.7,14900000,29.3,2019
Son of a Rich,50803834,0,0.0,50803834,100.0,2019
Kingdom,50574061,0,0.0,50574061,100.0,2019
Breakthrough,50444358,40713082,80.7,9731276,19.3,2019
Uncut Gems,50023780,50023780,100.0,0,0.0,2019
21 Bridges,49939757,28539757,57.1,21400000,42.9,2019
Song of Youth,49615508,0,0.0,49615508,100.0,2019
Little,48987096,40860481,83.4,8126615,16.6,2019
Isn't It Romantic,48791187,48791187,100.0,0,0.0,2019
The Legend of Hei,48507082,0,0.0,48507082,100.0,2019
Countdown,48021766,25621766,53.4,22400000,46.6,2019
Midsommar,47875193,27426361,57.3,20448832,42.7,2019
Queen & Slim,47834125,43808310,91.6,4025815,8.4,2019
47 Meters Down: Uncaged,47582563,22260900,46.8,25321663,53.2,2019
Chasing the Dragon II: Wild Wild Bunch,45733356,196634,0.4,45536722,99.6,2019
Judy,45701880,24313888,53.2,21387992,46.8,2019
Child's Play,44907074,29208403,65.0,15698671,35.0,2019
Richard Jewell,44645542,22345542,50.1,22300000,49.9,2019
Harriet,43347017,43082155,99.4,264862,0.6,2019
A Shaun the Sheep Movie: Farmageddon,43100248,0,0.0,43100248,100.0,2019
Fighting with My Family,41503392,22958886,55.3,18544506,44.7,2019
Masquerade Hotel,40396244,0,0.0,40396244,100.0,2019
The Last Wish,39756292,0,0.0,39756292,100.0,2019
Uri: The Surgical Strike,39346577,4186168,10.6,35160409,89.4,2019
Overcomer,38026103,34746945,91.4,3279158,8.6,2019
T034,37410850,0,0.0,37410850,100.0,2019
Pain and Glory,37359689,4567338,12.2,32792351,87.8,2019
A Witness Out of the Blue,37092694,0,0.0,37092694,100.0,2019
The Intruder,36599361,35419122,96.8,1180239,3.2,2019
The Queen's Corgi,35515687,0,0.0,35515687,100.0,2019
Warrior of the Hornor,34291831,0,0.0,34291831,100.0,2019
The Battle: Roar to Victory,34148707,0,0.0,34148707,100.0,2019
The Bad Guys: The Movie,34024386,166972,0.5,33857414,99.5,2019
The Good Liar,33856058,17156058,50.7,16700000,49.3,2019
The Art of Racing in the Rain,33766787,26395642,78.2,7371145,21.8,2019
Brightburn,33224654,17300439,52.1,15924215,47.9,2019
Bharat,33185983,2971549,9.0,30214434,91.0,2019
Fly Me to the Saitama,32802347,0,0.0,32802347,100.0,2019
UglyDolls,32450241,20150241,62.1,12300000,37.9,2019
Stuber,32390945,22370452,69.1,10020493,30.9,2019
Hit Me Anyone One More Time!,32333512,0,0.0,32333512,100.0,2019
Somewhere Winter,32218990,0,0.0,32218990,100.0,2019
The Kid Who Would Be King,32140970,16790790,52.2,15350180,47.8,2019
Two Tigers,32001580,0,0.0,32001580,100.0,2019
Anna,31626978,7743794,24.5,23883184,75.5,2019
My Dear Liar,31177968,90545,0.3,31087423,99.7,2019
The Wild Goose Lake,31064835,12573,0.0,31052262,100.0,2019
My Hero Academia: Heroes Rising,29971229,13304000,44.4,16667229,55.6,2019
Fall In Love At First Kiss,29206238,0,0.0,29206238,100.0,2019
Gully Boy,28299498,5566534,19.7,22732964,80.3,2019
Kim Ji0young: Born 1982,27696393,0,0.0,27696393,100.0,2019
Pok√©mon: Mewtwo Strikes Back 0 Evolution,27347118,0,0.0,27347118,100.0,2019
Almost a Comedy,26990962,0,0.0,26990962,100.0,2019
Total Dhamaal,26911995,2167632,8.1,24744363,91.9,2019
Missing Link,26565710,16649539,62.7,9916171,37.3,2019
No Manches Frida 2,26493648,9270920,35.0,17222728,65.0,2019
The Confidence Man JP,26228317,0,0.0,26228317,100.0,2019
The Confidence Man JP: The Movie,25958189,0,0.0,25958189,100.0,2019
The Gangster the Cop the Devil,25775371,216494,0.8,25558877,99.2,2019
Bodies at Rest,25293853,0,0.0,25293853,100.0,2019
Booksmart,24959607,22680962,90.9,2278645,9.1,2019
Super 30,24701637,2269878,9.2,22431759,90.8,2019
Skyfire,24444590,1105,0.0,24443485,100.0,2019
Start0Up,24106579,0,0.0,24106579,100.0,2019
A Rainy Day in New York,23805899,0,0.0,23805899,100.0,2019
The Peanut Butter Falcon,23712090,20457151,86.3,3254939,13.7,2019
Little White Lies 2,23623665,0,0.0,23623665,100.0,2019
Ossan's Love: Love or Dead,23422744,0,0.0,23422744,100.0,2019
Only Cloud Knows,23414998,0,0.0,23414998,100.0,2019
Dark Waters,23108017,11136084,48.2,11971933,51.8,2019
The Farewell,23076657,17695781,76.7,5380876,23.3,2019
The Knight of Shadows: Between Yin and Yang,22936257,0,0.0,22936257,100.0,2019
Black and Blue,22741061,22055313,97.0,685748,3.0,2019
Late Night,22386555,15499454,69.2,6887101,30.8,2019
Unplanned,21585326,19005109,88.0,2580217,12.0,2019
Crazy Romance,21386368,0,0.0,21386368,100.0,2019
Hotel Mumbai,21314816,9651611,45.3,11663205,54.7,2019
Integrity,21290004,0,0.0,21290004,100.0,2019
The Secret Mission,21083522,0,0.0,21083522,100.0,2019
This Is Tomas,20084169,0,0.0,20084169,100.0,2019
The Specials,19363826,0,0.0,19363826,100.0,2019
Always Miss You,19015465,91884,0.5,18923581,99.5,2019
An Officer and a Spy,18899214,0,0.0,18899214,100.0,2019
Crayon Shin0chan: Honeymoon Hurricane 0 The Lost Hiroshi,18738951,0,0.0,18738951,100.0,2019
Greta,18653107,10532219,56.5,8120888,43.5,2019
The Eight Hundred,461421559,372755,0.0,461048804,99.9,2020
Demon Slayer: Kimetsu no Yaiba 0 The Movie: Mugen Train,453230408,49505008,10.9,403725400,89.1,2020
Bad Boys for Life,426505244,206305244,48.4,220200000,51.6,2020
My People My Homeland,422390820,0,0.0,422390820,100.0,2020
Tenet,365304105,58504105,16.0,306800000,84.0,2020
Sonic the Hedgehog,319715683,148974665,46.6,170741018,53.4,2020
Dolittle,251410631,77047065,30.6,174363566,69.4,2020
Jiang Ziya,240646355,214670,0.0,240431685,99.9,2020
A Little Red Flower,216000000,0,0.0,216000000,100.0,2020
The Croods: A New Age,215905815,58568815,27.1,157337000,72.9,2020
Birds of Prey,205358461,84158461,41.0,121200000,59.0,2020
Shock Wave 2,198921659,0,0.0,198921659,100.0,2020
Wonder Woman 1984,169601036,46801036,27.6,122800000,72.4,2020
The Sacrifice,161047608,0,0.0,161047608,100.0,2020
The Invisible Man,144492724,70410000,48.7,74082724,51.3,2020
Onward,141940042,61555145,43.4,80384897,56.6,2020
Warm Hug,129240236,0,0.0,129240236,100.0,2020
Soul,121903885,946154,0.8,120957731,99.2,2020
The Call of the Wild,111166669,62342368,56.1,48824301,43.9,2020
Mamma Mia! Here We Go Again 2020 Re0release,85768073,0,0.0,85762586,100.0,2020
Mamma Mia! 2020 Re0release,84604815,0,0.0,84579977,100.0,2020
Caught in Time,80543319,0,0.0,80543319,100.0,2020
Mulan,69965374,0,0.0,69965374,100.0,2020
The Yin0Yang Master: Dream of Eternity,68000000,0,0.0,68000000,100.0,2020
Stand by Me Doraemon 2,65201374,0,0.0,65201374,100.0,2020
The Rescue,64237554,18797,0.0,64218757,100.0,2020
Love You Forever,60670799,0,0.0,60670799,100.0,2020
Greenland,52300000,0,0.0,52300000,100.0,2020
Tolo Tolo,52186426,0,0.0,52186426,100.0,2020
Vanguard,50866901,793525,1.6,50073376,98.4,2020
Fantasy Island,49447308,27309289,55.2,22138019,44.8,2020
Trolls World Tour,49276818,450000,0.9,48826818,99.1,2020
The New Mutants,49169594,23852659,48.5,25316935,51.5,2020
After We Collided,47990414,2386483,5.0,45603931,95.0,2020
From Today It's My Turn: The Movie,47895887,0,0.0,47895887,100.0,2020
Tanhaji: The Unsung Warrior,45221814,0,0.0,45221814,100.0,2020
Unhinged,44331465,20831465,47.0,23500000,53.0,2020
The End of Endless Love,43950000,0,0.0,43950000,100.0,2020
The War with Grandpa,43387638,21277892,49.0,22109746,51.0,2020
Peninsula,42698327,1231407,2.9,41466920,97.1,2020
Monster Hunter,42145959,15162470,36.0,26983489,64.0,2020
Underwater,40882928,17291078,42.3,23591850,57.7,2020
Bloodshot,39861118,12561824,31.5,27299294,68.5,2020
Sarileru Neekevvaru,37389889,821000,2.2,36568889,97.8,2020
The Untold Tale of the Three Kingdoms,36747486,0,0.0,36747486,100.0,2020
The Confidence Man JP: Princess,36109913,0,0.0,36109913,100.0,2020
The Man Standing Next,34664900,113527,0.3,34551373,99.7,2020
My Mom is a Character 3,34360029,0,0.0,34360029,100.0,2020
Doraemon the Movie: Nobita's New Dinosaur,34218525,0,0.0,34218525,100.0,2020
Harry Potter and the Sorcerer's Stone 2020 Re0release,31503136,0,0.0,31501815,100.0,2020
Honest Thief,31220247,14163574,45.4,17056673,54.6,2020
Like a Boss,30399490,22169514,72.9,8229976,27.1,2020
The Witches,29303571,203571,0.7,29100000,99.3,2020
Bath Buddy,28700000,0,0.0,28700000,100.0,2020
Scoob!,28588425,2188425,7.7,26400000,92.3,2020
Ala Vaikunthapurramuloo,28477890,0,0.0,28477890,100.0,2020
Black Panther 2020 Re0release,28046568,367000,1.3,27635191,98.5,2020
Emma.,25932444,10055355,38.8,15877089,61.2,2020
Leap,25818882,83074,0.3,25735808,99.7,2020
Gravity 2020 Re0release,24857278,0,0.0,24857244,100.0,2020
The Father,24048935,2122771,8.8,21920547,91.1,2020
Poupelle of Chimney Town,22715146,0,0.0,22715146,100.0,2020
Gretel & Hansel,22304357,15347654,68.8,6956703,31.2,2020
Stigmatized Properties,21276720,0,0.0,21276720,100.0,2020
Pok√©mon the Movie: Secrets of the Jungle,21097921,0,0.0,21097921,100.0,2020
The Photograph,20690779,20578185,99.5,112594,0.5,2020
Threads 0 Our Tapestry of Love,20474270,0,0.0,20474270,100.0,2020
Brahms: The Boy II,20311536,12611536,62.1,7700000,37.9,2020
Violet Evergarden: The Movie,20302668,0,0.0,20302668,100.0,2020
Interstellar 2020 Re0release,19990000,0,0.0,19990000,100.0,2020
Ice 2,19788995,0,0.0,19788995,100.0,2020
Soul Snatcher,19561221,0,0.0,19561221,100.0,2020
The Turning,19428166,15472775,79.6,3955391,20.4,2020
Fate/stay night [Heaven's Feel] III. spring song,19252497,200000,1.0,19052497,99.0,2020
Promising Young Woman,18854166,6460965,34.3,12393201,65.7,2020
Takizawa Enbujo Zero,18091395,0,0.0,18091395,100.0,2020
Freaky,18073433,9030855,50.0,9042578,50.0,2020
The Promised Neverland,17710977,0,0.0,17710977,100.0,2020
Kaiji: Final Game,17645779,0,0.0,17645779,100.0,2020
Hitman: Agent Jun,17601351,0,0.0,17601351,100.0,2020
Digimon Adventure: Last Evolution Kizuna,17361009,0,0.0,17361009,100.0,2020
Bye Bye Morons,16955924,0,0.0,16955924,100.0,2020
Baaghi 3,16726510,721439,4.3,16005071,95.7,2020
I Still Believe,16069730,9868521,61.4,6201209,38.6,2020
Father There is Only One 2,15373181,0,0.0,15373181,100.0,2020
The Personal History of David Copperfield,14399270,1876298,13.0,12522972,87.0,2020
Nightlife,14308789,0,0.0,14308789,100.0,2020
Pawn,14193957,0,0.0,14193957,100.0,2020
The Post 2020 Re0release,13995207,0,0.0,13995207,100.0,2020
#Alive,13432212,0,0.0,13432212,100.0,2020
Howling Village,13394556,0,0.0,13394556,100.0,2020
Come Play,13182254,10475990,79.5,2706264,20.5,2020
Samjin Company English Class,12761386,0,0.0,12761386,100.0,2020
Another Round,12745392,0,0.0,12742455,100.0,2020
News of the World,12668325,12668325,100.0,0,0.0,2020
Collectors,12640113,0,0.0,12640113,100.0,2020
Shinchan: Crash! Scribble Kingdom and Almost Four Heroes,12221804,0,0.0,12221804,100.0,2020
Ducobu 3,12157793,0,0.0,12157793,100.0,2020
The Asadas,11888743,0,0.0,11888743,100.0,2020
Wotakoi: Love Is Hard for Otaku,11702371,0,0.0,11702371,100.0,2020
Bigfoot Family,11126309,0,0.0,11126309,100.0,2020
30 jours max,11007713,0,0.0,11007713,100.0,2020
The Voice of Sin,10983063,0,0.0,10983063,100.0,2020
Two by Two: Overboard!,10885076,0,0.0,10885076,100.0,2020
Let Him Go,10835686,9358025,86.4,1477661,13.6,2020
One Second,10791301,0,0.0,10791301,100.0,2020
Me contro Te 0 Il film: La vendetta del Signor S,10779891,0,0.0,10779891,100.0,2020
Impractical Jokers: The Movie,10691091,10691091,100.0,0,0.0,2020
Honest Candidate,10597464,0,0.0,10597464,100.0,2020
The Hunt,10550350,5812500,55.1,4737850,44.9,2020
Street Dancer 3D,10339127,0,0.0,10339127,100.0,2020
My Spy,10200000,0,0.0,10200000,100.0,2020
100% Wolf,9766489,658764,6.7,9107725,93.3,2020
Stolen Identity 2,9687188,0,0.0,9687188,100.0,2020
Inception 10th Anniversary re0release,9581100,0,0.0,9581100,100.0,2020
10 Days with Dad,9472077,2359,0.0,9469718,100.0,2020
Secret Zoo,9471940,0,0.0,9471940,100.0,2020
365 Days,9458590,0,0.0,9458590,100.0,2020
Okay Madam,9433525,0,0.0,9433525,100.0,2020
L'appel de la for√™t,9317347,0,0.0,9317347,100.0,2020
Malasa√±a 32,8968845,0,0.0,8968845,100.0,2020
Break the Silence: The Movie,8954345,0,0.0,8954345,100.0,2020
I Hate Summer,8926071,0,0.0,8926071,100.0,2020
Downhill,8899195,8287061,93.1,612134,6.9,2020
Les blagues de Toto,8859185,0,0.0,8859185,100.0,2020
The Secret Garden,8721243,0,0.0,8721243,100.0,2020
Eltilerin Savasi,8613864,0,0.0,8613864,100.0,2020
Malang,8399765,0,0.0,8399765,100.0,2020
Your Eyes Tell,8020474,0,0.0,8020474,100.0,2020
My Donkey My Lover & I,7974769,152184,1.9,7821615,98.1,2020
AI Amok,7932191,0,0.0,7932191,100.0,2020
The Lost Prince,7837980,0,0.0,7837980,100.0,2020
Antebellum,7792716,0,0.0,7792716,100.0,2020
The Marriage Escape,7760946,0,0.0,7760946,100.0,2020
Spirited Away Studio Ghibli Fest 2020,7732697,0,0.0,7732435,100.0,2020
Princess Mononoke Studio Ghibli Fest 2020,7673800,0,0.0,7673207,100.0,2020
The Heist of the Century,7627100,0,0.0,7627100,100.0,2020
De Gaulle,7501454,0,0.0,7501454,100.0,2020
Fukushima 50,7494243,0,0.0,7494243,100.0,2020
The Best Years,7358771,0,0.0,7358771,100.0,2020
Bohemian Rhapsody 2020 Re0release,7158262,240000,3.4,6914052,96.6,2020
The (UN)perfect Guy,7154649,0,0.0,7154649,100.0,2020
Spycies,7128952,0,0.0,7128952,100.0,2020
Back to the Wharf,7090000,0,0.0,7090000,100.0,2020
Adu,7085946,0,0.0,7085946,100.0,2020
Fatale,7031289,6306897,89.7,724392,10.3,2020
Dragon Rider,6977378,0,0.0,6977378,100.0,2020
Jim Button and the Wild 13,6933267,0,0.0,6933267,100.0,2020
Psy 3: W imie zasad,6725146,0,0.0,6725146,100.0,2020
Blood Moon Party,6709383,0,0.0,6709383,100.0,2020
Innocence,6688330,0,0.0,6659968,99.6,2020
Shubh Mangal Zyada Saavdhan,6574905,0,0.0,6574905,100.0,2020
Chhapaak,6532100,604334,9.3,5927766,90.7,2020
Love Me Love Me Not,6494241,0,0.0,6494241,100.0,2020
Hammamet,6434874,0,0.0,6434874,100.0,2020
Lindenberg! Mach dein Ding,6404964,0,0.0,6404964,100.0,2020
Midnight Swan,6397065,0,0.0,6397065,100.0,2020
Nausica√§ of the Valley of the Wind 2020 Re0release,6395525,0,0.0,6395525,100.0,2020
Simply Black,6323750,0,0.0,6323750,100.0,2020
My Boyfriend's Meds,6292780,2971116,47.2,3321664,52.8,2020
Bill & Ted Face the Music,6274027,3439660,54.8,2834367,45.2,2020
Hotel Belgrade,6189882,0,0.0,6189882,100.0,2020
How to Be a Good Wife,6033430,0,0.0,6033430,100.0,2020
The Legacy of Dr. Death: Black File,6024046,0,0.0,6024046,100.0,2020
A Piece of Cake,6008448,0,0.0,6008448,100.0,2020
The Rhythm Section,5989583,5437971,90.8,551612,9.2,2020
How I Became a Gangster,5975729,0,0.0,5975729,100.0,2020
The Innocent,5929392,22549,0.4,5906843,99.6,2020
Twiceborn,5880157,11527,0.2,5868630,99.8,2020
The Royal Bride,5830719,0,0.0,5830719,100.0,2020
Beasts Clawing at Straws,5796059,0,0.0,5796059,100.0,2020
The Lion King 2020 Re0release,5773266,0,0.0,5773266,100.0,2020
Last Letter,5663972,0,0.0,5663972,100.0,2020
Yowamushi Pedal: The Movie 2020 Re0release,5624218,0,0.0,5624218,100.0,2020
Hocus Pocus 2020 Re0release,5609193,4828000,86.1,781193,13.9,2020
Klassikokkutulek 2: Pulmad ja matused,5543147,0,0.0,5543147,100.0,2020
Mama Weed,5461144,29151,0.5,5431993,99.5,2020
Divorce Club,5316313,0,0.0,5316313,100.0,2020
Cats & Dogs 3: Paws Unite,5300000,0,0.0,5300000,100.0,2020
Cindy La Regia,5222322,0,0.0,5222322,100.0,2020
Run,5184368,0,0.0,5184368,100.0,2020
Masked Ward,5107013,0,0.0,5107013,100.0,2020
Ayyappanum Koshiyum,5088713,0,0.0,5088713,100.0,2020
Baba Parasi,5084342,0,0.0,5084342,100.0,2020
Die K√§nguru0Chroniken,5081127,0,0.0,5081127,100.0,2020
The Real Exorcist,5035830,0,0.0,5035830,100.0,2020
Mayday,5011408,0,0.0,5011408,100.0,2020
Bheeshma,4997080,0,0.0,4997080,100.0,2020
Made in Abyss: Dawn of the Deep Soul,4971635,0,0.0,4971635,100.0,2020
Godai 0 The Wunderkind,4948225,0,0.0,4948225,100.0,2020
Military Wives,4890505,0,0.0,4890505,100.0,2020
Panga,4886124,582720,11.9,4303404,88.1,2020
The Tales for Old and Young,4853143,0,0.0,4853143,100.0,2020
Streltsov,4850073,0,0.0,4850073,100.0,2020
Persian Lessons,4849240,0,0.0,4849240,100.0,2020
The SpongeBob Movie: Sponge on the Run,4810790,4810790,100.0,0,0.0,2020
Spider0Man: No Way Home,1912233593,804793477,42.1,1107440116,57.9,2021
The Battle at Lake Changjin,902548476,342411,0.0,902206065,100.0,2021
Hi Mom,822009764,0,0.0,822009764,100.0,2021
No Time to Die,774153007,160891007,20.8,613262000,79.2,2021
F9: The Fast Saga,726229501,173005945,23.8,553223556,76.2,2021
Detective Chinatown 3,686257563,0,0.0,686257563,100.0,2021
Venom: Let There Be Carnage,506863592,213550366,42.1,293313226,57.9,2021
Godzilla vs. Kong,470116094,100916094,21.5,369200000,78.5,2021
Shang0Chi and the Legend of the Ten Rings,432243292,224543292,51.9,207700000,48.1,2021
Sing 2,408402685,162790990,39.9,245611695,60.1,2021
Eternals,402064899,164870234,41.0,237194665,59.0,2021
Dune: Part One,402027830,108327830,26.9,293700000,73.1,2021
Black Widow,379751655,183651655,48.4,196100000,51.6,2021
Free Guy,331526598,121626598,36.7,209900000,63.3,2021
A Quiet Place Part II,297372261,160072261,53.8,137300000,46.2,2021
Encanto,256786742,96093622,37.4,160693120,62.6,2021
Cruella,233503234,86103234,36.9,147400000,63.1,2021
My Country My Parents,221831086,177133,0.0,221653953,99.9,2021
Jungle Cruise,220889446,116987516,53.0,103901930,47.0,2021
The Conjuring: The Devil Made Me Do It,206431050,65631050,31.8,140800000,68.2,2021
Raging Fire,205842393,385305,0.2,205457088,99.8,2021
Ghostbusters: Afterlife,204334455,129360575,63.3,74973880,36.7,2021
Chinese Doctors,197143218,0,0.0,197143218,100.0,2021
Cliff Walkers,181325565,152972,0.0,181172593,99.9,2021
The Suicide Squad,168717425,55817425,33.1,112900000,66.9,2021
Jujutsu Kaisen 0,166760828,34542754,20.7,132218074,79.3,2021
Space Jam: A New Legacy,163692228,70592228,43.1,93100000,56.9,2021
The Matrix Resurrections,157386805,37686805,23.9,119700000,76.1,2021
Peter Rabbit 2: The Runaway,153901717,40501717,26.3,113400000,73.7,2021
House of Gucci,153269161,53809574,35.1,99459587,64.9,2021
A Writer's Odyssey,150123320,160013,0.1,149963307,99.9,2021
The Boss Baby 2: Family Business,146745280,57300280,39.0,89445000,61.0,2021
PAW Patrol: The Movie,144327371,40127371,27.8,104200000,72.2,2021
Tom & Jerry,136536687,46536687,34.1,90000000,65.9,2021
Be Somebody,132326332,0,0.0,132326332,100.0,2021
Halloween Kills,131647155,92002155,69.9,39645000,30.1,2021
Raya and the Last Dragon,130423032,54723032,42.0,75700000,58.0,2021
Sister,128317206,0,0.0,128317206,100.0,2021
The King's Man,125897478,37176373,29.5,88721105,70.5,2021
The Addams Family 2,119815153,56489153,47.1,63326000,52.9,2021
My Love,116720921,86252,0.0,116634669,99.9,2021
Clifford the Big Red Dog,107347356,48947356,45.6,58400000,54.4,2021
Wrath of Man,103966489,27466489,26.4,76500000,73.6,2021
Detective Conan: The Scarlet Bullet,95371578,0,0.0,95371578,100.0,2021
Evangelion: 3.0+1.01 Thrice Upon a Time,93882453,810744,0.9,93071709,99.1,2021
End Game,91824961,23149,0.0,91801812,100.0,2021
Old,90146510,48276510,53.6,41870000,46.4,2021
Mortal Kombat,84426031,42326031,50.1,42100000,49.9,2021
Boonie Bears: The Wild Life,78132231,0,0.0,78132231,100.0,2021
Candyman,77411570,61186570,79.0,16225000,21.0,2021
The Forever Purge,76994245,44539245,57.8,32455000,42.2,2021
West Side Story,76016171,38530322,50.7,37485849,49.3,2021
1921,75159828,0,0.0,75159828,100.0,2021
Hitman's Wife's Bodyguard,70060492,38014727,54.3,32045765,45.7,2021
Escape Room: Tournament of Champions,65774490,25314753,38.5,40459737,61.5,2021
Belle,64679830,4018313,6.2,60661517,93.8,2021
Ron's Gone Wrong,60692022,23009270,37.9,37682752,62.1,2021
Cloudy Mountain,58348836,0,0.0,58348836,100.0,2021
Avatar 2021 Re0release,57995770,0,0.0,57995770,100.0,2021
Nobody,57510518,27568035,47.9,29942483,52.1,2021
New Gods: Nezha Reborn,56088478,0,0.0,56088478,100.0,2021
Upcoming,54300000,0,0.0,54300000,100.0,2021
Don't Breathe 2,53785551,32712950,60.8,21072601,39.2,2021
Man in Love,52946097,0,0.0,52946097,100.0,2021
Break Through the Darkness,52700000,0,0.0,52700000,100.0,2021
Schemes in Antiques,51637422,36501,0.0,51600921,99.9,2021
Luca,51074773,1324302,2.6,49750471,97.4,2021
Belfast,49158709,9250870,18.8,39907839,81.2,2021
My Hero Academia: World Heroes' Mission,46940541,12271658,26.1,34668883,73.9,2021
The French Dispatch,46333545,16124375,34.8,30209170,65.2,2021
In the Heights,45175167,29975167,66.4,15200000,33.6,2021
Love Will Tear Us Apart,45060290,0,0.0,45060290,100.0,2021
Spirit Untamed,42717215,17716215,41.5,25001000,58.5,2021
Resident Evil: Welcome to Raccoon City,41914915,17000612,40.6,24914303,59.4,2021
Spiral,40618920,23216862,57.2,17402058,42.8,2021
Snake Eyes,40064325,28264325,70.5,11800000,29.5,2021
Tokyo Revengers,39714624,0,0.0,39714624,100.0,2021
Nightmare Alley,39629195,11338107,28.6,28291088,71.4,2021
Nomadland,39458207,3700000,9.4,35758207,90.6,2021
King Richard,39429285,15129285,38.4,24300000,61.6,2021
Arashi Anniversary Tour 5 x 20 Film: Record of Memories,38052695,0,0.0,38052695,100.0,2021
The Yinyang Master,37690000,0,0.0,37690000,100.0,2021
Rurouni Kenshin: Final Chapter Part I 0 The Final,36964978,0,0.0,36964978,100.0,2021
The Door Lock,36100000,0,0.0,36100000,100.0,2021
We Made a Beautiful Bouquet,35042879,0,0.0,35042879,100.0,2021
Malignant,34891791,13391791,38.4,21500000,61.6,2021
Licorice Pizza,33276075,17318007,52.0,15958068,48.0,2021
Respect,32882823,24278399,73.8,8604424,26.2,2021
Big Red Envelope,32800000,0,0.0,32800000,100.0,2021
Masquerade Night,32287400,0,0.0,32287400,100.0,2021
Once Upon a Time in Hong Kong,32218874,0,0.0,32218874,100.0,2021
Home Sweet Home,32178677,0,0.0,32178677,100.0,2021
The Little Things,30842746,15342746,49.7,15500000,50.3,2021
The Unholy,30832137,15532137,50.4,15300000,49.6,2021
The Last Duel,30552111,10853945,35.5,19698166,64.5,2021
Escape from Mogadishu,29902716,346271,1.2,29556445,98.8,2021
The Last Warrior: Root of Evil,28357398,0,0.0,28357398,100.0,2021
The Last Warrior: A Messenger of Darkness,27052365,0,0.0,27052365,100.0,2021
American Underdog,26514814,26514814,100.0,0,0.0,2021
Chaos Walking,26508132,13287908,50.1,13220224,49.9,2021
The Courier,26001227,6613432,25.4,19387795,74.6,2021
Spencer,25246967,7086632,28.1,18160335,71.9,2021
Parallel Mothers,23099858,2297501,9.9,20802357,90.1,2021
The Marksman,23076711,15566093,67.5,7510618,32.5,2021
99.9 Criminal Lawyer: The Movie,23055069,0,0.0,23055069,100.0,2021
Last Night in Soho,22957625,10127625,44.1,12830000,55.9,2021
The Day We Lit Up the Sky,22500000,0,0.0,22500000,100.0,2021
School of Magical Animals,22029698,288414,1.3,21741284,98.7,2021
Kaamelott: First Installment,21979122,188000,0.9,21791122,99.1,2021
After We Fell,21753705,2170750,10.0,19582955,90.0,2021
Rurouni Kenshin: Final Chapter Part II 0 The Beginning,21318560,0,0.0,21318560,100.0,2021
Wish Dragon,21120000,0,0.0,21120000,100.0,2021
Crayon Shin0chan: Shrouded in Mystery! The Flowers of Tenkazu Academy,20752104,0,0.0,20752104,100.0,2021
Stillwater,19754272,14465535,73.2,5288737,26.8,2021
The Wolf and the Lion,19510578,2072173,10.6,17438405,89.4,2021
Les Tuche 4,19259766,0,0.0,19259766,100.0,2021
Dear Evan Hansen,19133454,15002646,78.4,4130808,21.6,2021
Those Who Wish Me Dead,19107200,7407200,38.8,11700000,61.2,2021
The Pioneer,18900000,0,0.0,18900000,100.0,2021
The Green Knight,18887953,17173321,90.9,1714632,9.1,2021
Antlers,18867659,10619670,56.3,8247989,43.7,2021
Sinkhole,18816801,0,0.0,18816801,100.0,2021
Mobile Suit Gundam: Hathaway,18731309,0,0.0,18731309,100.0,2021
The Stronghold,18066143,0,0.0,18066143,100.0,2021
Dad I'm Sorry,17480489,350000,2.0,17130489,98.0,2021
Gintama: The Final,17252960,0,0.0,17252960,100.0,2021
Railway Heroes,17223704,0,0.0,17223704,100.0,2021
Your Turn to Kill,16511822,0,0.0,16511822,100.0,2021
Cry Macho,16510734,10310734,62.4,6200000,37.6,2021
Reminiscence,16400193,3900193,23.8,12500000,76.2,2021
Legend No. 17,16096860,0,0.0,16096860,100.0,2021
Upon the Magic Roads,15990882,0,0.0,15990882,100.0,2021
Harry Potter and the Sorcerer's Stone 2021 Re0release,15591681,799342,5.1,14604379,93.7,2021
The Dry,15576286,364237,2.3,15212049,97.7,2021
The Night House,15437703,7100581,46.0,8337122,54.0,2021
Drive My Car,15356410,2352240,15.3,13004170,84.7,2021
Minari,15288578,3110580,20.3,12177998,79.7,2021
Something About Love,15204017,0,0.0,15204017,100.0,2021
Anita,15017470,556632,3.7,14460838,96.3,2021
And So the Baton Is Passed,14403588,0,0.0,14403588,100.0,2021
The Tomorrow War,14400000,0,0.0,14400000,100.0,2021
Sword Art Online: Progressive 0 Aria of a Starless Night,14032747,1050000,7.5,12982747,92.5,2021
Christmas with the Chosen: The Messengers,13728000,13728000,100.0,0,0.0,2021
Eiffel,13573923,444814,3.3,13129109,96.7,2021
OSS 117: From Africa with Love,13457801,0,0.0,13457801,100.0,2021
Hostage: Missing Celebrity,13174292,0,0.0,13174292,100.0,2021
Vakeel Saab,13056490,0,0.0,13056490,100.0,2021
The Many Saints of Newark,13037403,8237403,63.2,4800000,36.8,2021
The Monkey King: Reborn,13017088,0,0.0,13017088,100.0,2021
No Escapes,12916151,0,0.0,12916151,100.0,2021
The Bodin's in the Land of Smile,12872253,0,0.0,12872253,100.0,2021
The Worst Person in the World,12687507,3034775,23.9,9652732,76.1,2021
Character,12628017,0,0.0,12628017,100.0,2021
On Your Mark,12100000,0,0.0,12100000,100.0,2021
On the Line,12058986,0,0.0,12058986,100.0,2021
Stand by Me,11900000,0,0.0,11900000,100.0,2021
The Fable: The Killer Who Doesn't Kill,11325545,0,0.0,11325545,100.0,2021
What Did You Eat Yesterday?,11320893,0,0.0,11320893,100.0,2021
Aline,11149943,667815,6.0,10482128,94.0,2021
Krack,10442916,0,0.0,10442916,100.0,2021
Realm of Terracotta,10363914,0,0.0,10363914,100.0,2021
Kaiserschmarrndrama,10357720,0,0.0,10357720,100.0,2021
Caution Hazardous Wife: The Movie,10356359,0,0.0,10356359,100.0,2021
Detective Conan: The Scarlet Alibi,10308627,0,0.0,10308627,100.0,2021
Never Stop,10224935,0,0.0,10224935,100.0,2021
Ainbo,10172403,0,0.0,10172403,100.0,2021
Eiga Sumikkogurashi: Aoi tsukiyo no mah√¥ no ko,9742510,0,0.0,9742510,100.0,2021
Black Box,9738741,0,0.0,9738741,100.0,2021
The Soul,9600000,0,0.0,9600000,100.0,2021
¬°A todo tren! Destino Asturias,9544171,0,0.0,9544171,100.0,2021
Baragaki: Unbroken Samurai,9481437,0,0.0,9481437,100.0,2021
Dad,9267397,0,0.0,9267397,100.0,2021
The Lord of the Rings: The Fellowship of the Ring 2021 Re0release,8990599,0,0.0,8377569,93.2,2021
All About My Mother,8900000,0,0.0,8900000,100.0,2021
The Eleventh Chapter,8844997,0,0.0,8844997,100.0,2021
The Medium,8826689,0,0.0,8826689,100.0,2021
The Vault,8803864,0,0.0,8803864,100.0,2021
Kaguya0sama: Love Is War,8794981,0,0.0,8794981,100.0,2021
Moonbound,8749618,0,0.0,8749618,100.0,2021
The Prot√©g√©,8737253,7446823,85.2,1290430,14.8,2021
Lost Illusions,8635184,126391,1.5,8508793,98.5,2021
Agent Backkom: King's Bear,8619446,0,0.0,8619446,100.0,2021
Pil's Adventures,8567345,0,0.0,8567345,100.0,2021
Honey Lemon Soda,8441488,0,0.0,8441488,100.0,2021
Delicious,8371523,0,0.0,8371523,100.0,2021
I Don't Have Any Money Left in My Retirement Account,8204616,0,0.0,8204616,100.0,2021
Girls to Buy,8177284,0,0.0,8177284,100.0,2021
Green Snake,8170000,0,0.0,8170000,100.0,2021
New Happy Dad and Son 4,8070000,0,0.0,8070000,100.0,2021
Sunny Sisters,7880000,0,0.0,7880000,100.0,2021
Contra,7762797,0,0.0,7762797,100.0,2021
Hard Hit,7658021,0,0.0,7658021,100.0,2021
Little Canned Men,7600000,0,0.0,7600000,100.0,2021
Pushpa: The Rise 0 Part 1,7592374,1320000,17.4,6272374,82.6,2021
The Mauritanian,7527030,836536,11.1,6690494,88.9,2021
The Ice Road,7502846,0,0.0,7502846,100.0,2021
Judas and the Black Messiah,7478009,5478009,73.3,2000000,26.7,2021
Love Letter 2021 Re0release,7400000,0,0.0,7400000,100.0,2021
Signal: The Movie,7388603,0,0.0,7388603,100.0,2021
Avatar: The Way of Water,2320250281,684075767,29.5,1636174514,70.5,2022
Top Gun: Maverick,1495696292,718732821,48.1,776963471,51.9,2022
Jurassic World Dominion,1001978080,376851080,37.6,625127000,62.4,2022
Doctor Strange in the Multiverse of Madness,955775804,411331607,43.0,544444197,57.0,2022
Minions: The Rise of Gru,940203765,370270765,39.4,569933000,60.6,2022
Black Panther: Wakanda Forever,859208836,453829060,52.8,405379776,47.2,2022
The Batman,772245583,369345583,47.8,402900000,52.2,2022
Thor: Love and Thunder,760928081,343256830,45.1,417671251,54.9,2022
Water Gate Bridge,626571697,117294,0.0,626454403,100.0,2022
Puss in Boots: The Last Wish,481726788,186090535,38.6,295636253,61.4,2022
Moon Man,460237662,0,0.0,460237662,100.0,2022
Fantastic Beasts: The Secrets of Dumbledore,407150844,95850844,23.5,311300000,76.5,2022
Uncharted,407141258,148648820,36.5,258492438,63.5,2022
Sonic the Hedgehog 2,405421518,190872904,47.1,214548614,52.9,2022
Black Adam,393452111,168152111,42.7,225300000,57.3,2022
Elvis,287740048,151040048,52.5,136700000,47.5,2022
The Bad Guys,250387888,97459240,38.9,152928648,61.1,2022
Bullet Train,239268602,103368602,43.2,135900000,56.8,2022
Lightyear,226425420,118307188,52.2,108118232,47.8,2022
Smile,217408513,105935048,48.7,111473465,51.3,2022
Too Cool to Kill,217254604,185882,0.0,217068722,99.9,2022
Nice View,211019042,0,0.0,211019042,100.0,2022
DC League of Super0Pets,207557117,93657117,45.1,113900000,54.9,2022
The Lost City,192907684,105344029,54.6,87563655,45.4,2022
M3GAN,180089109,95159005,52.8,84930104,47.2,2022
One Piece Film: Red,171319579,12775324,7.5,158544255,92.5,2022
Nope,171235592,123277080,72.0,47958512,28.0,2022
Ticket to Paradise,168770985,68275985,40.5,100495000,59.5,2022
Morbius,167460961,73865530,44.1,93595431,55.9,2022
RRR,165955146,14500000,8.7,151455146,91.3,2022
The Black Phone,161440742,90123230,55.8,71317512,44.2,2022
The First Slam Dunk,151712242,1291869,0.9,150420373,99.1,2022
Where the Crawdads Sing,144353965,90230760,62.5,54123205,37.5,2022
Everything Everywhere All at Once,139402341,77191785,55.4,62210556,44.6,2022
Scream,137743924,81641405,59.3,56102519,40.7,2022
Death on the Nile,137307235,45630104,33.2,91677131,66.8,2022
Suzume,133473196,10932037,8.2,122541159,91.8,2022
A Man Called Otto,113359847,64267657,56.7,49092190,43.3,2022
Lyle Lyle Crocodile,111080122,46888441,42.2,64191681,57.8,2022
Halloween Ends,104374176,64079860,61.4,40294316,38.6,2022
The Roundup,101166707,812859,0.8,100353848,99.2,2022
The Woman King,97562514,67328130,69.0,30234384,31.0,2022
Downton Abbey: A New Era,92651384,44141550,47.6,48509834,52.4,2022
K.G.F: Chapter 2,89123940,2874000,3.2,86249940,96.8,2022
Don't Worry Darling,87609403,45309403,51.7,42300000,48.3,2022
Dragon Ball Super: Super Hero,86562140,38112140,44.0,48450000,56.0,2022
Dog,84550282,61778069,73.1,22772213,26.9,2022
Jackass Forever,80563999,57743451,71.7,22820548,28.3,2022
The Menu,79628200,38501125,48.4,41127075,51.6,2022
Chebi: My Fluffy Friend,77609926,0,0.0,77609926,100.0,2022
Avatar 2022 Re0release,76012917,24714024,32.5,51298893,67.5,2022
Violent Night,76004405,50057405,65.9,25947000,34.1,2022
Strange World,73621640,37968963,51.6,35652677,48.4,2022
Detective Conan: The Bride of Halloween,72699093,0,0.0,72699093,100.0,2022
The Northman,69633110,34233110,49.2,35400000,50.8,2022
Moonfall,67319703,19060660,28.3,48234703,71.7,2022
Babylon,63562440,15351455,24.2,48210985,75.8,2022
Whitney Houston: I Wanna Dance with Somebody,59806881,23708080,39.6,36098801,60.4,2022
Beast,59095809,31846530,53.9,27249279,46.1,2022
The Whale,57615635,17463630,30.3,39563064,68.7,2022
Hansan: Rising Dragon,57490985,865888,1.5,56625097,98.5,2022
Confidential Assignment 2: International,54486330,0,0.0,54486330,100.0,2022
Ambulance,52303589,22781115,43.6,29522474,56.4,2022
Marry Me,50541093,22438180,44.4,28102913,55.6,2022
Brahmastra Part One: Shiva,50164785,7839108,15.6,42325677,84.4,2022
The Banshees of Inisherin,49262687,10582266,21.5,38680421,78.5,2022
The Fabelmans,45647323,17348945,38.0,28298378,62.0,2022
Barbarian,45352337,40842944,90.1,4509393,9.9,2022
Prey for the Devil,44658929,19802293,44.3,24856636,55.7,2022
Paws of Fury: The Legend of Hank,42439184,17811382,42.0,24627802,58.0,2022
The Invitation,38036130,25100080,66.0,12936050,34.0,2022
Orphan: First Kill,37083743,5413227,14.6,31670516,85.4,2022
Matilda: The Musical,35617120,0,0.0,35617120,100.0,2022
Kingdom 2: Far and Away,34963395,0,0.0,34963395,100.0,2022
The Bob's Burgers Movie,34148750,31933830,93.5,2214920,6.5,2022
Hunt,33821338,25994,0.0,33795344,99.9,2022
Tad the Lost Explorer and the Emerald Tablet,32849430,67599,0.2,32781831,99.8,2022
BTS Permission to Dance on Stage 0 Seoul: Live Viewing,32600000,6840000,21.0,25760000,79.0,2022
Shin Ultraman,32137136,601490,1.9,31535646,98.1,2022
Amsterdam,31245810,14947969,47.8,16297841,52.2,2022
Mrs. Harris Goes to Paris,31042050,10433915,33.6,20608135,66.4,2022
Vikram,29837637,1770000,5.9,28067637,94.1,2022
The Unbearable Weight of Massive Talent,29116320,20300157,69.7,8816163,30.3,2022
T√°r,29048571,6773650,23.3,22274921,76.7,2022
Serial (Bad) Weddings 3,27832384,0,0.0,27832384,100.0,2022
The 355,27827745,14570455,52.4,13257290,47.6,2022
The Last 10 Years,26729106,0,0.0,26729106,100.0,2022
The Night Owl,26719364,0,0.0,26719364,100.0,2022
Triangle of Sadness,26214659,4608096,17.6,21606563,82.4,2022
The Kashmir Files,24821898,1485000,6.0,23336898,94.0,2022
The Confidence Man JP: Episode of the Hero,23214581,0,0.0,23214581,100.0,2022
The Witch: Part 2 0 The Other One,23068596,143723,0.6,22924873,99.4,2022
Doraemon the Movie: Nobita's Little Star Wars 2021,22044058,0,0.0,22044058,100.0,2022
Decision to Leave,22026067,2179864,9.9,19846203,90.1,2022
See How They Run,21966634,9586237,43.6,12380397,56.4,2022
Ponniyin Selvan: Part I,21888295,4282000,19.6,17606295,80.4,2022
Devotion,21768133,20511938,94.2,1256195,5.8,2022
Silent Parade,21723595,0,0.0,21723595,100.0,2022
Father Stu,21592379,20884796,96.7,707583,3.3,2022
Turning Red,21521622,1399001,6.5,20122621,93.5,2022
Emergency Declaration,21400327,412196,1.9,20988131,98.1,2022
The Amazing Maurice,21134768,4303645,20.4,16831123,79.6,2022
Crayon Shin0chan: Mononoke Ninja Chinpuden,20617005,0,0.0,20617005,100.0,2022
Three Thousand Years of Longing,20282422,8286741,40.9,11995681,59.1,2022
School of Magical Animals 2,19724705,45860,0.2,19678845,99.8,2022
After Ever Happy,19238073,1072750,5.6,18165323,94.4,2022
Simone: Woman of the Century,19167164,0,0.0,19167164,100.0,2022
Broker,18851416,1046899,5.6,17804517,94.4,2022
Godfather,18737287,0,0.0,18737287,100.0,2022
November,18554715,0,0.0,18554715,100.0,2022
Bhool Bhulaiyaa 2,18307258,0,0.0,18307258,100.0,2022
Fragments of the Last Will,17954691,0,0.0,17954691,100.0,2022
The Quintessential Quintuplets Movie,17506171,502000,2.9,17004171,97.1,2022
Fall,17363261,7240521,41.7,10122740,58.3,2022
Even If This Love Disappears from the World Tonight,16848229,0,0.0,16848229,100.0,2022
Wundersch√∂n,16719291,0,0.0,16719291,100.0,2022
Father There Is Only One 3,16401315,0,0.0,16401315,100.0,2022
Dr. Coto's Clinic,16062841,0,0.0,16062841,100.0,2022
Radhe Shyam,15954804,1860000,11.7,14094804,88.3,2022
Blacklight,15902207,9591094,60.3,6311113,39.7,2022
Operation Mincemeat,15710164,0,0.0,15710164,100.0,2022
Maison de retraite,15570823,0,0.0,15570823,100.0,2022
Utapri Movie 2 Uta No Prince0Sama Maji Love Starish Tours Movie,15569229,0,0.0,15569229,100.0,2022
Bheemla Nayak,15243922,0,0.0,15243922,100.0,2022
Bones and All,15234907,7834907,51.4,7400000,48.6,2022
Terrifier 2,15065239,10640105,70.6,4425134,29.4,2022
Firestarter,15039250,9739250,64.8,5300000,35.2,2022
The Wolf of Wall Street 2022 Re0release,15038738,0,0.0,14877539,98.9,2022
Bros,14781867,11628165,78.7,3153702,21.3,2022
Superwho?,14770359,0,0.0,14770359,100.0,2022
X,14740889,11765309,79.8,2975580,20.2,2022
The Chosen Season 3: Episode 1 & 2,14679613,14612089,99.5,67524,0.5,2022
The Duke,14233027,1526970,10.7,12700247,89.2,2022
Sarkaru Vaari Paata,14199018,0,0.0,14199018,100.0,2022
She Said,13944212,5825995,41.8,8118217,58.2,2022
The Legend of Maula Jatt,13941539,5016493,36.0,8925046,64.0,2022
Bodies Bodies Bodies,13929670,11446602,82.2,2483068,17.8,2022
Glass Onion,13280000,13280000,100.0,0,0.0,2022
Valimai,13276393,0,0.0,13276393,100.0,2022
Memory,13240559,7329043,55.4,5911516,44.6,2022
Moonage Daydream,13095781,4218925,32.2,8876856,67.8,2022
Easter Sunday,13074255,13013690,99.5,60565,0.5,2022
Living,12377310,3038113,24.5,9339197,75.5,2022
Guglhupfgeschwader,12307072,0,0.0,12307072,100.0,2022
Alienoid,12109608,168309,1.4,11941299,98.6,2022
Laal Singh Chaddha,12093536,3401324,28.1,8692212,71.9,2022
That Time I Got Reincarnated as a Slime the Movie: Scarlet Bond,11628645,1588491,13.7,10040154,86.3,2022
Till,11498884,9000202,78.3,2498682,21.7,2022
Jug Jugg Jeeyo,11467726,1033000,9.0,10434726,91.0,2022
Empire of Light,11395604,1177577,10.3,10218027,89.7,2022
The Eight Mountains,11374298,302456,2.7,11071842,97.3,2022
Bergen,11325405,0,0.0,11325405,100.0,2022
Rise,11252331,0,0.0,11252331,100.0,2022
Men,11152071,7587853,68.0,3564218,32.0,2022
Chickenhare and the Hamster of Darkness,10885116,0,0.0,10885116,100.0,2022
Warriors of Future,10490328,0,0.0,10490328,100.0,2022
Land of Legends,10357479,0,0.0,10357479,100.0,2022
The Pirates: The Last Royal Treasure,10258331,0,0.0,10258331,100.0,2022
Vaillante,10143170,0,0.0,10143170,100.0,2022
Table for Six,10138355,0,0.0,10138355,100.0,2022
The Beasts,10067896,46105,0.5,10021791,99.5,2022
Smack Dab Kakha,9995945,0,0.0,9995945,100.0,2022
F3: Fun and Frustration,9849193,1195000,12.1,8654193,87.9,2022
Pearl,9847490,9423445,95.7,424045,4.3,2022
Good Luck to You Leo Grande,9795364,0,0.0,9795364,100.0,2022
Rheingold,9701747,0,0.0,9701747,100.0,2022
Spider0Man: No Way Home 2022 Re0release,9613518,9321593,97.0,291925,3.0,2022
Redeeming Love,9464198,9214020,97.4,250178,2.6,2022
Women Talking,9276103,5456531,58.8,3819572,41.2,2022
Sword Art Online the Movie: Progressive 0 Scherzo of Deep Night,9071701,0,0.0,9071701,100.0,2022
Samrat Prithviraj,8568339,0,0.0,8568339,100.0,2022
Aftersun,8477235,1658790,19.6,6818445,80.4,2022
Life Is Beautiful,8458639,0,0.0,8458639,100.0,2022
Yolki 9,8385030,0,0.0,8385030,100.0,2022
Shotgun Wedding,8277788,0,0.0,8277788,100.0,2022
Vikram Vedha,8234166,1589362,19.3,6644804,80.7,2022
Re/Member,8166175,0,0.0,8166175,100.0,2022
Rabbit Academy: Mission Eggpossible,8119534,0,0.0,8119534,100.0,2022
Acharya,8048175,832000,10.3,7216175,89.7,2022
Il grande giorno,8021940,0,0.0,8021940,100.0,2022
The Tatta's,8000956,0,0.0,8000956,100.0,2022
Ducobu 4 President,7858171,0,0.0,7858171,100.0,2022
Finnick,7591889,0,0.0,7591889,100.0,2022
Phases of the Moon,7564756,0,0.0,7564756,100.0,2022
777 Charlie,7523995,0,0.0,7523995,100.0,2022
Bachchhan Paandey,7387882,0,0.0,7387882,100.0,2022
Lesson in Murder,7348964,0,0.0,7348964,100.0,2022
Family Affairs,7330755,0,0.0,7330755,100.0,2022
Listy do M. 5,7328061,0,0.0,7328061,100.0,2022
Laid0Back Camp Movie,7317913,0,0.0,7317913,100.0,2022
Osomatsusan the Movie 2022 Re0release,7297522,0,0.0,7297522,100.0,2022
The New Toy,7295051,0,0.0,7295051,100.0,2022
Decibel,7212471,60579,0.8,7151892,99.2,2022
The Kids Are Alright 2,7187470,0,0.0,7187470,100.0,2022
Barbie,1445638421,636238421,44.0,809400000,56.0,2023
The Super Mario Bros. Movie,1361992475,574934330,42.2,787058145,57.8,2023
Oppenheimer,975440031,329862540,33.8,645577491,66.2,2023
Guardians of the Galaxy Vol. 3,845555777,358995815,42.5,486559962,57.5,2023
Fast X,704875015,146126015,20.7,558749000,79.3,2023
Spider0Man: Across the Spider0Verse,690615475,381311319,55.2,309304156,44.8,2023
Wonka,632302312,218402312,34.5,413900000,65.5,2023
The Little Mermaid,569626289,298172056,52.3,271454233,47.7,2023
Mission: Impossible 0 Dead Reckoning Part One,567535383,172135383,30.3,395400000,69.7,2023
Elemental,496444308,154426697,31.1,342017611,68.9,2023
Ant0Man and the Wasp: Quantumania,476071180,214504909,45.1,261566271,54.9,2023
John Wick: Chapter 4,440157245,187131806,42.5,253025439,57.5,2023
Transformers: Rise of the Beasts,438966392,157066392,35.8,281900000,64.2,2023
Aquaman and the Lost Kingdom,434381226,124481226,28.7,309900000,71.3,2023
Meg 2: The Trench,397700317,82600317,20.8,315100000,79.2,2023
Indiana Jones and the Dial of Destiny,383963057,174480468,45.4,209482589,54.6,2023
The Hunger Games: The Ballad of Songbirds & Snakes,344357763,166350594,48.3,178007169,51.7,2023
Migration,299161774,127306285,42.6,171855489,57.4,2023
Five Nights at Freddy's,291493620,137275620,47.1,154218000,52.9,2023
Creed III,276148615,156248615,56.6,119900000,43.4,2023
The Flash,271333313,108133313,39.9,163200000,60.1,2023
The Nun II,269467073,86267073,32.0,183200000,68.0,2023
Taylor Swift: The Eras Tour,261656269,180756269,69.1,80900000,30.9,2023
Wish,254997360,63973821,25.1,191023539,74.9,2023
Sound of Freedom,250570396,184178046,73.5,66392350,26.5,2023
Napoleon,221394838,61524375,27.8,159870463,72.2,2023
Anyone But You,220213795,88319668,40.1,131894127,59.9,2023
Trolls Band Together,209367510,102996915,49.2,106370595,50.8,2023
Dungeons & Dragons: Honor Among Thieves,208177026,93277026,44.8,114900000,55.2,2023
The Marvels,206136825,84500223,41.0,121636602,59.0,2023
PAW Patrol: The Mighty Movie,202231360,65231360,32.3,137000000,67.7,2023
The Equalizer 3,191067560,92373751,48.3,98693809,51.7,2023
Insidious: The Red Door,189086877,82156962,43.4,106929915,56.6,2023
Teenage Mutant Ninja Turtles: Mutant Mayhem,180513586,118613586,65.7,61900000,34.3,2023
The Boy and the Heron,173635417,46832867,27.0,126802550,73.0,2023
Scream VI,168961389,108161389,64.0,60800000,36.0,2023
Killers of the Flower Moon,157026901,68026901,43.3,89000000,56.7,2023
Evil Dead Rise,147033054,67233054,45.7,79800000,54.3,2023
The Exorcist: Believer,136284218,65537395,48.1,70746823,51.9,2023
Shazam! Fury of the Gods,134038006,57638006,43.0,76400000,57.0,2023
Blue Beetle,130788072,72488072,55.4,58300000,44.6,2023
A Haunting in Venice,122290456,42471412,34.7,79819044,65.3,2023
Gran Turismo,122101055,44428554,36.4,77672501,63.6,2023
Poor Things,117625455,34553225,29.4,83072230,70.6,2023
Haunted Mansion,117449790,67653287,57.6,49796503,42.4,2023
Godzilla Minus One,115857413,56418793,48.7,59438620,51.3,2023
Pathaan,112583450,17487476,15.5,95095974,84.5,2023
Saw X,111823047,53607898,47.9,58215149,52.1,2023
Detective Conan: Black Iron Submarine,106771806,0,0.0,106771806,100.0,2023
The Creator,104272136,40774679,39.1,63497457,60.9,2023
12.12: The Day,97476565,0,0.0,97476565,100.0,2023
Animal,92870950,15004482,16.2,77866468,83.8,2023
Talk to Me,92181735,48299436,52.4,43882299,47.6,2023
Air,90060106,52460106,58.3,37600000,41.7,2023
Cocaine Bear,88314672,64670240,73.2,23644432,26.8,2023
No Hard Feelings,87256407,50452282,57.8,36804125,42.2,2023
The Roundup: No Way Out,83410298,909411,1.1,82500887,98.9,2023
The Pope's Exorcist,76987621,20009380,26.0,56978241,74.0,2023
Plane,74515586,32111181,43.1,42404405,56.9,2023
Titanic 25 Year Anniversary,70157472,15033795,21.4,55123677,78.6,2023
The Color Purple,67519191,60619191,89.8,6900000,10.2,2023
The Boogeyman,67307243,43244282,64.2,24062961,35.8,2023
65,60730568,32062904,52.8,28667664,47.2,2023
Spy x Family Code: White,59629242,8110042,13.6,51519200,86.4,2023
Magic Mike's Last Dance,57105156,26005156,45.5,31100000,54.5,2023
Demon Slayer: Kimetsu No Yaiba 0 To the Swordsmith Village,56319794,10117806,18.0,46201988,82.0,2023
One Life,56205538,5716885,10.2,50488653,89.8,2023
The Boys in the Boat,55501365,52641306,94.8,2860059,5.2,2023
Knock at the Cabin,54760947,35397980,64.6,19362967,35.4,2023
Mummies,54475970,4275970,7.8,50200000,92.2,2023
Jesus Revolution,54295801,52102987,96.0,2192814,4.0,2023
Asteroid City,53857743,28153025,52.3,25704718,47.7,2023
The Zone of Interest,52582035,8659464,16.5,43922571,83.5,2023
Operation Fortune: Ruse de Guerre,48983306,6496125,13.3,42487181,86.7,2023
Missing,48767848,32502025,66.6,16265823,33.4,2023
There's Still Tomorrow,48489294,0,0.0,48489294,100.0,2023
Thanksgiving,46553280,31908884,68.5,14644396,31.5,2023
Asterix & Obelix: The Middle Kingdom,46497678,0,0.0,46497678,100.0,2023
Ruby Gillman: Teenage Kraken,45657745,15753600,34.5,29904145,65.5,2023
The Holdovers,45478184,20355375,44.8,25122809,55.2,2023
The Iron Claw,45202541,35070296,77.6,10132245,22.4,2023
Son of a Rich 2,44718015,0,0.0,44718015,100.0,2023
Renaissance: A Film by Beyonc√©,43989684,33889684,77.0,10100000,23.0,2023
Ferrari,43336670,18550028,42.8,24786642,57.2,2023
Past Lives,42543213,11185625,26.3,31357588,73.7,2023
80 for Brady,40362938,39330588,97.4,1032350,2.6,2023
Miraculous: Ladybug & Cat Noir the Movie,40209224,0,0.0,40209224,100.0,2023
My Big Fat Greek Wedding 3,38831076,28496030,73.4,10335046,26.6,2023
The Expendables 4,37917985,16710153,44.1,21207832,55.9,2023
Doraemon the Movie: Nobita's Sky Utopia,37475850,0,0.0,37475850,100.0,2023
Smugglers,36851831,0,0.0,36851831,100.0,2023
Kingdom 3: The Flame of Destiny,36259522,0,0.0,36259522,100.0,2023
Ride On,36258730,128950,0.4,36129780,99.6,2023
Strays,36071267,23988885,66.5,12082382,33.5,2023
Anatomy of a Fall,35947604,5076369,14.1,30871235,85.9,2023
The Bremen Town Musicians,34596570,0,0.0,34596570,100.0,2023
Noryang: Deadly Sea,34210966,315245,0.9,33895721,99.1,2023
Alibi.com 2,34114308,0,0.0,34114308,100.0,2023
Priscilla,33111634,20960939,63.3,12150695,36.7,2023
Don't Call it Mystery: The Movie,32488540,0,0.0,32488540,100.0,2023
The Three Musketeers 0 Part I: D'Artagnan,32375003,0,0.0,32375003,100.0,2023
Tokyo MER,30239900,0,0.0,30239900,100.0,2023
Concrete Utopia,30077348,0,0.0,30077348,100.0,2023
BTS: Yet to Come in Cinemas,29291883,8093270,27.6,21198613,72.4,2023
Book Club: The Next Chapter,29014500,17581565,60.6,11432935,39.4,2023
I Wish I Could Meet You Again on the Hill Where That Flower Blooms (2023),28933626,0,0.0,28933626,100.0,2023
Jawan,28499044,15198530,53.3,13300514,46.7,2023
The Wish of the Fairy Fish,28218581,0,0.0,28218581,100.0,2023
Toy Story 2023 Re0release,27503758,0,0.0,27503758,100.0,2023
Renfield,26493921,17297895,65.3,9196026,34.7,2023
Perfect Days,25417760,3766668,14.8,21651092,85.2,2023
Gravity 2023 Re0release (10th Anniversary),24981634,0,0.0,24981634,100.0,2023
Frozen 2023 Re0release (Sing 0A0Long),24395877,0,0.0,24395877,100.0,2023
Shin Jigen! Crayon Shin0chan the Movie,23655553,0,0.0,23655553,100.0,2023
The Challenge,23219519,0,0.0,23219519,100.0,2023
American Fiction,22483370,21098470,93.8,1384900,6.2,2023
Radical,21791709,8702731,39.9,13088978,60.1,2023
The Last Voyage of the Demeter,21786275,13637180,62.6,8149095,37.4,2023
Guy Ritchie's the Covenant,21632392,16938039,78.3,4694353,21.7,2023
Are You There God? It's Me Margaret.,21464043,20372406,94.9,1091637,5.1,2023
IDOLiSH7 Movie: LIVE 4bit 0 BEYOND THE PERiOD,21112012,0,0.0,21112012,100.0,2023
Saltburn,21026167,11425829,54.3,9600338,45.7,2023
Dumb Money,20703794,13925356,67.3,6761614,32.7,2023
All of Us Strangers,20226058,4050103,20.0,16175955,80.0,2023
My Happy Marriage,19506407,0,0.0,19506407,100.0,2023
The House of No Man,19490980,0,0.0,19490980,100.0,2023
Retribution,18685751,6937696,37.1,11748055,62.9,2023
Next Goal Wins,18648802,6713826,36.0,11934976,64.0,2023
Love Reset,18425590,0,0.0,18425590,100.0,2023
The Blackening,18169453,17707207,97.5,462246,2.5,2023
About My Father,18167819,12089391,66.5,6078428,33.5,2023
The Birth of Kitaro: Mystery of GeGeGe,18136207,0,0.0,18136207,100.0,2023
Mavka: The Forest Song,17974964,0,0.0,17974964,100.0,2023
The Blind,17265487,17265487,100.0,0,0.0,2023
Tokyo Revengers 2: Bloody Halloween 0 Destiny,17216567,0,0.0,17216567,100.0,2023
Hypnotic,16281937,4500169,27.6,11781768,72.4,2023
The Legend & Butterfly,16087771,0,0.0,16087771,100.0,2023
Die drei ??? 0 Erbe des Drachen,15860016,0,0.0,15860016,100.0,2023
Shin Kamen Rider,15835414,0,0.0,15835414,100.0,2023
Dunki,15473051,7460159,48.2,8012892,51.8,2023
The Three Musketeers 0 Part II: Milady,15432295,0,0.0,15432295,100.0,2023
Only 3 Days Left,15152854,0,0.0,15152854,100.0,2023
Tonde Saitama: Biwako Yori Ai o Komete,15107891,0,0.0,15107891,100.0,2023
A Guilty Conscience,14911562,0,0.0,14911562,100.0,2023
Epic Tails,14883959,355088,2.4,14528871,97.6,2023
Tokyo Revengers 2: Bloody Halloween 0 Decisive Battle,14584970,0,0.0,14584970,100.0,2023
Dr. Cheon and Lost Talisman,14574445,84362,0.6,14490083,99.4,2023
Jeanne du Barry,14344699,0,0.0,14344699,100.0,2023
Sisu,14281199,7265622,50.9,7015577,49.1,2023
Rehragout0Rendezvous,14127069,0,0.0,14127069,100.0,2023
A Moroccan Affair,14075140,0,0.0,14075140,100.0,2023
His Only Son,13817186,12392740,89.7,1424446,10.3,2023
The Point Men,13433834,0,0.0,13433834,100.0,2023
Manta Manta: Legacy,13078126,0,0.0,13078126,100.0,2023
Three heroes and the Navel of the Earth,13028535,0,0.0,13028535,100.0,2023
Bottoms,12976079,12036071,92.8,940008,7.2,2023
Championext,12877645,0,0.0,12877645,100.0,2023
Dream Scenario,12763763,5742193,45.0,7021570,55.0,2023
Love Again,12696584,6230837,49.1,6465747,50.9,2023
Beau Is Afraid,12337378,8176562,66.3,4160816,33.7,2023
The Shift,12238643,12118219,99.0,120424,1.0,2023
Salaar,11958548,8929282,74.7,3029266,25.3,2023
After Death,11830860,11478326,97.0,352534,3.0,2023
Tiger 3,11713932,5365263,45.8,6348669,54.2,2023
Face Off 6: The Ticket of Destiny,11538081,0,0.0,11538081,100.0,2023
Jungle Bunch: Operation Meltdown,11505418,831200,7.2,10674218,92.8,2023
Silent Night,11067228,8012103,72.4,3055125,27.6,2023
What's Love Got to Do with It?,11065050,0,0.0,11065050,100.0,2023
Sleep,11022466,0,0.0,11022466,100.0,2023
Samurai Beyond Admiration Record to the World's Best,10876188,0,0.0,10876188,100.0,2023
Honey Sweet,10766032,0,0.0,10766032,100.0,2023
The Machine,10664328,10458331,98.1,205997,1.9,2023
After Everything,10644463,0,0.0,10644463,100.0,2023
The Crime Is Mine,10432369,122083,1.2,10310286,98.8,2023
The Nightmare Before Christmas 30th Anniversary Re0Release,10431631,10251956,98.3,179675,1.7,2023
The Great Escaper,10265608,0,0.0,10265608,100.0,2023
Freelance,10197391,5314136,52.1,4883255,47.9,2023
Sun and Concrete,10119958,0,0.0,10119958,100.0,2023
Cobweb,10091821,0,0.0,10091821,100.0,2023
The Peasants,10053062,155188,1.5,9897874,98.5,2023
The Taste of Things,9973327,2654510,26.6,7318817,73.4,2023
Talk to Her Undated France Release,9550733,0,0.0,9549770,100.0,2023
House Party,9285747,9002247,96.9,283500,3.1,2023
Rafadan Tayfa 4: Hayrimat√∂r,9156422,0,0.0,9156422,100.0,2023
The Animal Kingdom,9138503,11767,0.1,9126736,99.9,2023
All Your Faces,9065011,0,0.0,9065011,100.0,2023
Cats in the Museum,9019640,0,0.0,9019640,100.0,2023
The Wandering Earth II,8854786,5023132,56.7,3831654,43.3,2023
Father & Soldier,8598322,0,0.0,8598322,100.0,2023
PreCure All Stars F,8557763,0,0.0,8557763,100.0,2023
Dream,8317251,0,0.0,8317251,100.0,2023
Vacaciones de verano,8209854,0,0.0,8209854,100.0,2023
On the Wandering Paths,8187125,0,0.0,8187125,100.0,2023
Weekend Rebels,8184539,0,0.0,8184539,100.0,2023
Ransomed,8101634,142101,1.8,7959533,98.2,2023
Checker Tobi und die Reise zu den fliegenden Fl√ºssen,7953344,0,0.0,7953344,100.0,2023
The Silent Service,7836539,0,0.0,7836539,100.0,2023
Inside Out 2,1595983694,637852840,40.0,958130854,60.0,2024
Deadpool & Wolverine,1043180185,506937007,48.6,536243178,51.4,2024
Despicable Me 4,808537571,332583715,41.1,475953856,58.9,2024
Dune: Part Two,711844358,282144358,39.6,429700000,60.4,2024
Godzilla x Kong: The New Empire,567650016,196350016,34.6,371300000,65.4,2024
Kung Fu Panda 4,547820030,193590620,35.3,354229410,64.7,2024
Bad Boys: Ride or Die,400124003,193375986,48.3,206748017,51.7,2024
Kingdom of the Planet of the Apes,397366385,171118400,43.1,226247985,56.9,2024
Twisters,313866855,225866855,72.0,88000000,28.0,2024
A Quiet Place: Day One,260894737,138694737,53.2,122200000,46.8,2024
The Garfield Movie,227064902,91859556,40.5,135205346,59.5,2024
Ghostbusters: Frozen Empire,201856657,113376590,56.2,88480067,43.8,2024
IF,190146808,111149917,58.5,78996891,41.5,2024
Bob Marley: One Love,180746602,96893170,53.6,83853432,46.4,2024
The Fall Guy,178372311,92900355,52.1,85471956,47.9,2024
Furiosa: A Mad Max Saga,172775791,67475791,39.1,105300000,60.9,2024
The Beekeeper,152720535,66220535,43.4,86500000,56.6,2024
Civil War,122533193,68603430,56.0,53929763,44.0,2024
Detective Conan: The Million-Dollar Pentagram,106751233,0,0.0,106751233,100.0,2024
Madame Web,100298817,43817106,43.7,56481711,56.3,2024
Exhuma,97986040,2310900,2.4,95675140,97.6,2024
Argylle,96221031,45207275,47.0,51013756,53.0,2024
Longlegs,94250549,71791631,76.2,22458918,23.8,2024
Challengers,94219408,50119408,53.2,44100000,46.8,2024
It Ends with Us,93384596,63432082,67.9,29952514,32.1,2024
Haikyuu!! The Dumpster Battle,93220807,7071622,7.6,86149185,92.4,2024
The Roundup: Punishment,83539202,1154475,1.4,82384727,98.6,2024
A Little Something Extra,77015599,0,0.0,77015599,100.0,2024
Night Swim,54744768,32494740,59.4,22250028,40.6,2024
The First Omen,53845880,20092802,37.3,33753078,62.7,2024
Back to Black,50856606,6157705,12.1,44698901,87.9,2024
Tarot,49127750,18771004,38.2,30356746,61.8,2024
The Count of Monte-Cristo,48137114,0,0.0,48137114,100.0,2024
The Strangers: Chapter 1,47758326,35202562,73.7,12555764,26.3,2024
Trap,47179448,30479448,64.6,16700000,35.4,2024
Demon Slayer: Kimetsu No Yaiba - To the Hashira Training,44354825,17657658,39.8,26697167,60.2,2024
Imaginary,43600455,28009161,64.2,15591294,35.8,2024
Abigail,42411043,25867515,61.0,16543528,39.0,2024
Arthur the King,40835924,25049006,61.3,15786918,38.7,2024
Fly Me to the Moon,40540700,20317630,50.1,20223070,49.9,2024
The Bikeriders,35625207,21714630,61.0,13910577,39.0,2024
Monkey Man,35004952,25116955,71.8,9887997,28.2,2024
Horizon: An American Saga - Chapter 1,34258604,29035702,84.8,5222902,15.2,2024
The Watchers,32971404,19071404,57.8,13900000,42.2,2024
Doraemon the Movie: Nobita's Earth Symphony,32759618,0,0.0,32759618,100.0,2024
Mobile Suit Gundam Seed Freedom,32125992,0,0.0,32125992,100.0,2024
A Strange House,30864331,0,0.0,30864331,100.0,2024
Chantal in Fairyland,28567561,0,0.0,28567561,100.0,2024
Immaculate,28414678,15671307,55.2,12743371,44.8,2024
The Master and Margarita,27989335,0,0.0,27989335,100.0,2024
The Ministry of Ungentlemanly Warfare,27403786,20535053,74.9,6868733,25.1,2024
Wicked Little Letters,27024623,5008179,18.5,22016444,81.5,2024
Kalki 2898 AD,25341218,18289575,72.2,7051643,27.8,2024
Kingdom 4: Return of the Great General,22954872,0,0.0,22954872,100.0,2024
Mai,21714524,0,0.0,21714524,100.0,2024
Autumn and the Black Jaguar,21495226,0,0.0,21495226,100.0,2024
Unsung Hero,21195064,20335239,95.9,859825,4.1,2024
MaXXXine,20879276,15082039,72.2,5797237,27.8,2024
Lyod 3,20615744,0,0.0,20615744,100.0,2024
Ordinary Angels,20566982,19174421,93.2,1392561,6.8,2024
Cabrini,20457011,19512134,95.4,944877,4.6,2024
Pilot,20297907,0,0.0,20297907,100.0,2024
La plan√®te des singes une odyss√©e de l'esp√®ce,19515102,0,0.0,19515102,100.0,2024
Star Wars: Episode I - The Phantom Menace 2024 Re-release,19429994,13029994,67.1,6400000,32.9,2024
Face Off 7: One Wish,19353760,0,0.0,19353760,100.0,2024
Golden Kamuy,19077748,0,0.0,19077748,100.0,2024
Harold and the Purple Crayon,19072061,13985241,73.3,5086820,26.7,2024
Cocorico,18037432,0,0.0,18037432,100.0,2024
Escape,17868057,251793,1.4,17616264,98.6,2024
Guest from the Future,17744561,0,0.0,17744561,100.0,2024
Twilight of the Warriors: Walled In,16506349,144871,0.9,16361478,99.1,2024
Kleks Academy,15348026,0,0.0,15348026,100.0,2024
Borderlands,14959526,10239545,68.4,4719981,31.6,2024
The Chosen: S4 Episodes 1-3,14873918,14409169,96.9,464749,3.1,2024
Late Night with the Devil,14847115,10001000,67.4,4846115,32.6,2024
Hijack 1971,14076578,242069,1.7,13834509,98.3,2024
Kinds of Kindness,13507340,5038931,37.3,8468409,62.7,2024
Blue Lock: Episode Nagi,13381837,1855384,13.9,11526453,86.1,2024
Article 370,13222021,1088790,8.2,12133231,91.8,2024
Letuchiy korabl,12886684,0,0.0,12886684,100.0,2024
Love Lies Bleeding,12604176,8335797,66.1,4268379,33.9,2024
Handsome Guys,12391582,0,0.0,12391582,100.0,2024
Citizen of a Kind,11976305,0,0.0,11976305,100.0,2024
Sound of Hope: The Story of Possum Trot,11607239,11607239,100.0,0,0.0,2024
Maison de retraite 2,11196943,0,0.0,11196943,100.0,2024
Father There is Only One 4,11144131,0,0.0,11144131,100.0,2024
A Million Minutes,11077140,0,0.0,11077140,100.0,2024
Cat and Dog,10718048,0,0.0,10718048,100.0,2024
Alienoid: The Return to the Future,10693858,60720,0.6,10633138,99.4,2024
Lisa Frankenstein,9927714,9774285,98.5,153429,1.5,2024
The Exorcism,9483691,4530418,47.8,4953273,52.2,2024
The Chosen: S4 Episodes 4-6,9482744,9482744,100.0,0,0.0,2024
Thelma,9438984,8707914,92.3,731070,7.7,2024
A Smile Doesn't Lie,9211570,0,0.0,9211570,100.0,2024
Onegin,9201680,0,0.0,9201680,100.0,2024
Abudeka Is Back,9163586,0,0.0,9163586,100.0,2024
Lohusa,8809952,0,0.0,8809952,100.0,2024
Following,8793810,0,0.0,8793810,100.0,2024
Dear Family,8528605,0,0.0,8528605,100.0,2024
Uma Musume: Pretty Derby - Beginning of a New Era,8501860,0,0.0,8501860,100.0,2024
The Birth of Korea,8022137,0,0.0,8022137,100.0,2024
Un mondo a parte,7933123,0,0.0,7933123,100.0,2024
Drive-Away Dolls,7931124,5028215,63.4,2902909,36.6,2024
The Chosen: S4 Episodes 7-8,7768191,7729152,99.5,39039,0.5,2024
Look Back,7535037,0,0.0,7535037,100.0,2024
Ducobu passe au vert!,7510050,0,0.0,7510050,100.0,2024
Kolpa√ßino 4 4'l√ºk,7343114,0,0.0,7343114,100.0,2024
Yolo,7241348,2001584,27.6,5239764,72.4,2024
Sight,7205755,7205755,100.0,0,0.0,2024
Land of Bad,6938728,4620045,66.6,2318683,33.4,2024
SUGA: Agust D Tour 'D-DAY' the Movie,6791851,1951896,28.7,4839955,71.3,2024
April Come She Will,6719810,0,0.0,6719810,100.0,2024
Major Grom: The Game,6677169,0,0.0,6677169,100.0,2024
Troll Factory,6676327,0,0.0,6676327,100.0,2024
I.S.S.,6605079,6573799,99.5,31280,0.5,2024
10 Lives,6592377,0,0.0,6592377,100.0,2024
Baghead,6550820,0,0.0,6550820,100.0,2024
The Book of Clarence,6205230,6132813,98.8,72417,1.2,2024
Columbia 100th Anniversary Series Columbia 100th Anniversary Series,6013515,6013515,100.0,0,0.0,2024
Project Silence,6007712,0,0.0,6007712,100.0,2024
Force of Nature: The Dry 2,5786313,58690,1.0,5727623,99.0,2024
Dragonkeeper,5501438,805091,14.6,4696347,85.4,2024
N'avoue jamais,5374417,0,0.0,5374417,100.0,2024
Matching,5348492,0,0.0,5348492,100.0,2024
Kyu Ju Sai. Nani ga Medetai,5285231,0,0.0,5285231,100.0,2024
Hit Man,5265220,0,0.0,5265220,100.0,2024
I Saw the TV Glow,5208941,5017817,96.3,191124,3.7,2024
The Goat Life,5138042,625000,12.2,4513042,87.8,2024
Fr√®res,5127599,0,0.0,5127599,100.0,2024
Table for Six 2,4871447,0,0.0,4871447,100.0,2024
GHOST: Rite Here Rite Now,4772954,2647702,55.5,2125252,44.5,2024
In a Violent Nature,4546186,4229999,93.0,316187,7.0,2024
18√ó2 Beyond Youthful Days,4512194,0,0.0,4512194,100.0,2024
No Way Up,4465228,148582,3.3,4316646,96.7,2024
Anweshippin Kandethum,4459155,0,0.0,4459155,100.0,2024
Our Folks: The Beginning,4433525,0,0.0,4433525,100.0,2024
El Roomie,4418253,0,0.0,4418253,100.0,2024
La familia Benet√≥n,4355202,0,0.0,4355202,100.0,2024
Wonderland,4270030,0,0.0,4270030,100.0,2024
Noah's Ark,4185520,0,0.0,4185520,100.0,2024
Meet the Leroys,4180181,0,0.0,4180181,100.0,2024
Maria Montessori,4175860,0,0.0,4175860,100.0,2024
I soliti idioti 3: Il ritorno,4174340,0,0.0,4174340,100.0,2024
How to Make Millions Before Grandma Dies,4099079,0,0.0,4099079,100.0,2024
Crew,4015089,1500000,37.4,2515089,62.6,2024
Dune: Part One 2024 Re-release,3995610,0,0.0,3995610,100.0,2024
Cuckoo,3946664,3882280,98.4,64384,1.6,2024
Babes,3867121,3800038,98.3,67083,1.7,2024
Fighter,3800771,1000000,26.3,2800771,73.7,2024
Manjummel Boys,3784106,0,0.0,3784106,100.0,2024
The Second Act,3781122,0,0.0,3781122,100.0,2024
Daaaaaali!,3766743,0,0.0,3766743,100.0,2024
Gap Lai Chi Bau,3749297,0,0.0,3749297,100.0,2024
Jatt & Juliet 3,3701206,1515000,40.9,2186206,59.1,2024
Aavesham,3694257,0,0.0,3694257,100.0,2024
Ezra,3625005,2631460,72.6,993545,27.4,2024
Onmyoji Zero,3566021,0,0.0,3566021,100.0,2024
Pare parecchio Parigi,3560667,0,0.0,3560667,100.0,2024
Breaking Point,3559250,0,0.0,3559250,100.0,2024
Detective Conan vs. Kid the Phantom Thief,3546772,0,0.0,3546772,100.0,2024
Z√°pisn√≠k alkoholicky,3532733,0,0.0,3532733,100.0,2024
The Moon Thieves,3522654,0,0.0,3522654,100.0,2024
The Plot,3490849,0,0.0,3490849,100.0,2024
Peppa's Cinema Party,3473576,0,0.0,3473576,100.0,2024
Shrek 2 2024 Re-release,3427910,3427910,100.0,0,0.0,2024
3391 Kilometres,3424225,0,0.0,3424225,100.0,2024
The Lord of the Rings: The Fellowship of the Ring 2024 Re-release,3392950,3256658,96.0,135895,4.0,2024
The Buried Talent,3387736,0,0.0,3387736,100.0,2024
Manyunya. Priklyucheniya v Moskve,3381430,0,0.0,3381430,100.0,2024
Lovesick Ellie,3365139,0,0.0,3365139,100.0,2024
Bocchi the Rock! Re:,3350047,0,0.0,3350047,100.0,2024
Bol√©ro,3335618,0,0.0,3335618,100.0,2024
La petite vadrouille,3285001,0,0.0,3285001,100.0,2024
Let's Go! Anpanman: Baikinman and Lulun,3279803,0,0.0,3279803,100.0,2024
Gondola,3278905,0,0.0,3278905,100.0,2024
Boy Kills World,3269468,2626127,80.3,643341,19.7,2024
Lucky Winners,3256901,0,0.0,3256901,100.0,2024
Baby boom or Eggnog 5,3236512,0,0.0,3236512,100.0,2024
The Fabulous Four,3211180,2836571,88.3,374609,11.7,2024
The Lord of the Rings: The Two Towers 2024 Re-release,3204720,2566412,80.1,635532,19.8,2024
2024 Oscar Nominated Short Films: Documentary,3162293,3162293,100.0,0,0.0,2024
The Good Teacher,3120799,0,0.0,3120799,100.0,2024
Budda. Dzieciak '98,3085668,0,0.0,3085668,100.0,2024
Loving Bali,3069304,0,0.0,3069304,100.0,2024
The Long Game,3060040,3060040,100.0,0,0.0,2024
Tri bogatyrya. Ni dnya bez podviga,3044127,0,0.0,3044127,100.0,2024
White Bird,3039128,0,0.0,3039128,100.0,2024
Kensuke's Kingdom,3028140,0,0.0,3028140,100.0,2024
Voditel-oligarkh,2971712,0,0.0,2971712,100.0,2024
Too Old for Fairy Tales 2,2962925,0,0.0,2962925,100.0,2024
Siccin 7,2947685,0,0.0,2947685,100.0,2024
Jesus Thirsts: The Miracle of the Eucharist,2927121,2927121,100.0,0,0.0,2024
Buzz House: The Movie,2910112,0,0.0,2910112,100.0,2024
We 12,2864154,0,0.0,2864154,100.0,2024
Me Contro Te - Il film: Operazione Spie,2798501,0,0.0,2798501,100.0,2024
Menudas piezas,2778043,0,0.0,2778043,100.0,2024
Silent Love,2739320,0,0.0,2739320,100.0,2024
